Month,Year,Full-time,Part-time,Grand Total,Quarter,AirlineID
1,1990,4993,714,5707,1,AS
2,1990,5010,751,5761,1,AS
3,1990,5066,760,5826,1,AS
4,1990,5110,802,5912,2,AS
5,1990,5277,779,6056,2,AS
6,1990,5512,782,6294,2,AS
7,1990,5522,780,6302,3,AS
8,1990,5532,779,6311,3,AS
9,1990,5277,856,6133,3,AS
10,1990,5348,853,6201,4,AS
11,1990,5276,820,6096,4,AS
12,1990,5308,818,6126,4,AS
1,1991,5230,793,6023,1,AS
2,1991,5271,786,6057,1,AS
3,1991,5311,780,6091,1,AS
4,1991,5366,795,6161,2,AS
5,1991,5565,821,6386,2,AS
6,1991,5806,838,6644,2,AS
7,1991,5910,797,6707,3,AS
8,1991,5895,822,6717,3,AS
9,1991,5767,795,6562,3,AS
10,1991,5753,820,6573,4,AS
11,1991,5723,823,6546,4,AS
12,1991,5775,828,6603,4,AS
1,1992,5697,821,6518,1,AS
2,1992,5710,822,6532,1,AS
3,1992,5710,860,6570,1,AS
4,1992,5830,890,6720,2,AS
5,1992,6073,879,6952,2,AS
6,1992,6207,946,7153,2,AS
7,1992,6249,924,7173,3,AS
8,1992,6177,930,7107,3,AS
9,1992,6051,877,6928,3,AS
10,1992,5993,884,6877,4,AS
11,1992,5854,879,6733,4,AS
12,1992,5729,882,6611,4,AS
1,1993,5729,882,6611,1,AS
2,1993,5417,886,6303,1,AS
3,1993,5534,847,6381,1,AS
4,1993,5470,859,6329,2,AS
5,1993,5757,923,6680,2,AS
6,1993,5966,869,6835,2,AS
7,1993,6009,871,6880,3,AS
8,1993,5868,862,6730,3,AS
9,1993,5688,812,6500,3,AS
10,1993,5407,790,6197,4,AS
11,1993,5410,819,6229,4,AS
12,1993,5424,806,6230,4,AS
1,1994,5444,804,6248,1,AS
2,1994,5577,730,6307,1,AS
3,1994,5624,744,6368,1,AS
4,1994,5671,752,6423,2,AS
5,1994,5897,841,6738,2,AS
6,1994,6077,875,6952,2,AS
7,1994,6131,888,7019,3,AS
8,1994,6162,839,7001,3,AS
9,1994,6041,830,6871,3,AS
10,1994,6076,841,6917,4,AS
11,1994,6074,843,6917,4,AS
12,1994,6077,847,6924,4,AS
1,1995,6072,831,6903,1,AS
2,1995,6091,809,6900,1,AS
3,1995,6091,868,6959,1,AS
4,1995,6075,851,6926,2,AS
5,1995,6300,927,7227,2,AS
6,1995,6358,1023,7381,2,AS
7,1995,6406,1044,7450,3,AS
8,1995,6407,993,7400,3,AS
9,1995,6403,972,7375,3,AS
10,1995,6415,946,7361,4,AS
11,1995,6475,930,7405,4,AS
12,1995,6515,953,7468,4,AS
1,1996,6524,971,7495,1,AS
2,1996,6630,908,7538,1,AS
3,1996,6695,894,7589,1,AS
4,1996,6685,949,7634,2,AS
5,1996,6837,979,7816,2,AS
6,1996,7081,1053,8134,2,AS
7,1996,7141,1051,8192,3,AS
8,1996,7153,1035,8188,3,AS
9,1996,7050,1043,8093,3,AS
10,1996,7076,1045,8121,4,AS
11,1996,7145,1059,8204,4,AS
12,1996,7219,1098,8317,4,AS
1,1997,7206,1061,8267,1,AS
2,1997,7253,1082,8335,1,AS
3,1997,7284,1088,8372,1,AS
4,1997,7314,1151,8465,2,AS
5,1997,7435,1194,8629,2,AS
6,1997,7435,1194,8629,2,AS
7,1997,7675,1231,8906,3,AS
8,1997,7637,1207,8844,3,AS
9,1997,7599,1195,8794,3,AS
10,1997,7496,1163,8659,4,AS
11,1997,7477,1188,8665,4,AS
12,1997,7426,1157,8583,4,AS
1,1998,7439,1176,8615,1,AS
2,1998,7548,1189,8737,1,AS
3,1998,7637,1188,8825,1,AS
4,1998,7698,1214,8912,2,AS
5,1998,7884,1284,9168,2,AS
6,1998,7997,1326,9323,2,AS
7,1998,8024,1373,9397,3,AS
8,1998,8018,1370,9388,3,AS
9,1998,7899,1377,9276,3,AS
10,1998,7911,1358,9269,4,AS
11,1998,7927,1345,9272,4,AS
12,1998,7946,1357,9303,4,AS
1,1999,7916,1326,9242,1,AS
2,1999,8027,1315,9342,1,AS
3,1999,8142,1301,9443,1,AS
4,1999,8283,1306,9589,2,AS
5,1999,8346,1308,9654,2,AS
6,1999,8441,1325,9766,2,AS
7,1999,8515,1299,9814,3,AS
8,1999,8519,1297,9816,3,AS
9,1999,8413,1308,9721,3,AS
10,1999,8354,1286,9640,4,AS
11,1999,8400,1258,9658,4,AS
12,1999,8387,1270,9657,4,AS
1,2000,8360,1241,9601,1,AS
2,2000,8372,1239,9611,1,AS
3,2000,8395,1218,9613,1,AS
4,2000,8460,1197,9657,2,AS
5,2000,8582,1185,9767,2,AS
6,2000,8704,1204,9908,2,AS
7,2000,8726,1178,9904,3,AS
8,2000,8821,1170,9991,3,AS
9,2000,8726,1178,9904,3,AS
10,2000,8917,1204,10121,4,AS
11,2000,9066,1214,10280,4,AS
12,2000,9112,1221,10333,4,AS
1,2001,9172,1203,10375,1,AS
2,2001,9317,1253,10570,1,AS
3,2001,9450,1227,10677,1,AS
4,2001,9494,1245,10739,2,AS
5,2001,9623,1308,10931,2,AS
6,2001,9680,1286,10966,2,AS
7,2001,9670,1309,10979,3,AS
8,2001,9620,1313,10933,3,AS
9,2001,9487,1339,10826,3,AS
10,2001,9408,1319,10727,4,AS
11,2001,9195,1362,10557,4,AS
12,2001,9179,1336,10515,4,AS
1,2002,9141,1323,10464,1,AS
2,2002,9161,1326,10487,1,AS
3,2002,9204,1336,10540,1,AS
4,2002,9359,1331,10690,2,AS
5,2002,9564,1309,10873,2,AS
6,2002,9621,1338,10959,2,AS
7,2002,9635,1354,10989,3,AS
8,2002,9659,1332,10991,3,AS
9,2002,9612,1341,10953,3,AS
10,2002,9508,1307,10815,4,AS
11,2002,9545,1307,10852,4,AS
12,2002,9521,1302,10823,4,AS
1,2003,9539,1265,10804,1,AS
2,2003,9496,1290,10786,1,AS
3,2003,9479,1291,10770,1,AS
4,2003,9477,1281,10758,2,AS
5,2003,9530,1313,10843,2,AS
6,2003,9589,1252,10841,2,AS
7,2003,9562,1236,10798,3,AS
8,2003,9499,1220,10719,3,AS
9,2003,9405,1245,10650,3,AS
10,2003,9329,1228,10557,4,AS
11,2003,9339,1225,10564,4,AS
12,2003,9315,1218,10533,4,AS
1,2004,9286,1222,10508,1,AS
2,2004,9333,1231,10564,1,AS
3,2004,9241,1198,10439,1,AS
4,2004,9379,1237,10616,2,AS
5,2004,9529,1257,10786,2,AS
6,2004,9580,1235,10815,2,AS
7,2004,9643,1213,10856,3,AS
8,2004,9590,1184,10774,3,AS
9,2004,9216,1185,10401,3,AS
10,2004,9107,1141,10248,4,AS
11,2004,8827,1102,9929,4,AS
12,2004,8747,1110,9857,4,AS
1,2005,8626,1105,9731,1,AS
2,2005,8633,1112,9745,1,AS
3,2005,8653,1106,9759,1,AS
4,2005,8653,1148,9801,2,AS
5,2005,8387,1034,9421,2,AS
6,2005,8356,1027,9383,2,AS
7,2005,8491,995,9486,3,AS
8,2005,8490,996,9486,3,AS
9,2005,8514,1008,9522,3,AS
10,2005,8509,1014,9523,4,AS
11,2005,8497,1000,9497,4,AS
12,2005,8464,996,9460,4,AS
1,2006,8501,1027,9528,1,AS
2,2006,8490,1059,9549,1,AS
3,2006,8614,1058,9672,1,AS
4,2006,8695,1052,9747,2,AS
5,2006,8778,1056,9834,2,AS
6,2006,8931,1054,9985,2,AS
7,2006,8885,1114,9999,3,AS
8,2006,8953,1105,10058,3,AS
9,2006,8865,1114,9979,3,AS
10,2006,8841,1133,9974,4,AS
11,2006,8864,1096,9960,4,AS
12,2006,8882,1084,9966,4,AS
1,2007,8803,1079,9882,1,AS
2,2007,8818,1054,9872,1,AS
3,2007,8959,1042,10001,1,AS
4,2007,8937,1054,9991,2,AS
5,2007,9012,1050,10062,2,AS
6,2007,9082,1028,10110,2,AS
7,2007,9319,995,10314,3,AS
8,2007,9326,995,10321,3,AS
9,2007,9205,1071,10276,3,AS
10,2007,9288,1078,10366,4,AS
11,2007,9306,1098,10404,4,AS
12,2007,9302,1122,10424,4,AS
1,2008,9305,1120,10425,1,AS
2,2008,9368,1142,10510,1,AS
3,2008,9437,1158,10595,1,AS
4,2008,9481,1156,10637,2,AS
5,2008,9518,1152,10670,2,AS
6,2008,9557,1134,10691,2,AS
7,2008,9510,1125,10635,3,AS
8,2008,9440,1137,10577,3,AS
9,2008,9197,1227,10424,3,AS
10,2008,9213,1274,10487,4,AS
11,2008,8986,1283,10269,4,AS
12,2008,8937,1258,10195,4,AS
1,2009,8892,1220,10112,1,AS
2,2009,8893,1197,10090,1,AS
3,2009,8843,1202,10045,1,AS
4,2009,8877,1190,10067,2,AS
5,2009,8875,1185,10060,2,AS
6,2009,8946,1149,10095,2,AS
7,2009,8885,1168,10053,3,AS
8,2009,8798,1187,9985,3,AS
9,2009,8690,1275,9965,3,AS
10,2009,8637,1306,9943,4,AS
11,2009,8625,1293,9918,4,AS
12,2009,8620,1290,9910,4,AS
1,2010,8598,1288,9886,1,AS
2,2010,8591,1273,9864,1,AS
3,2010,8560,1276,9836,1,AS
4,2010,8535,1285,9820,2,AS
5,2010,8535,1283,9818,2,AS
6,2010,8583,1216,9799,2,AS
7,2010,8561,1198,9759,3,AS
8,2010,8511,1216,9727,3,AS
9,2010,8432,1248,9680,3,AS
10,2010,8321,1273,9594,4,AS
11,2010,8337,1278,9615,4,AS
12,2010,8321,1266,9587,4,AS
1,2011,8321,1265,9586,1,AS
2,2011,8269,1263,9532,1,AS
3,2011,8251,1275,9526,1,AS
4,2011,8277,1244,9521,2,AS
5,2011,8346,1238,9584,2,AS
6,2011,8450,1186,9636,2,AS
7,2011,8433,1173,9606,3,AS
8,2011,8342,1231,9573,3,AS
9,2011,8298,1258,9556,3,AS
10,2011,8283,1260,9543,4,AS
11,2011,8315,1258,9573,4,AS
12,2011,8340,1259,9599,4,AS
1,2012,8335,1259,9594,1,AS
2,2012,8379,1256,9635,1,AS
3,2012,8406,1249,9655,1,AS
4,2012,8406,1249,9655,2,AS
5,2012,8546,1246,9792,2,AS
6,2012,8607,1230,9837,2,AS
7,2012,8601,1224,9825,3,AS
8,2012,8629,1221,9850,3,AS
9,2012,8537,1337,9874,3,AS
10,2012,8533,1344,9877,4,AS
11,2012,8540,1336,9876,4,AS
12,2012,8607,1323,9930,4,AS
1,2013,8578,1344,9922,1,AS
2,2013,8648,1320,9968,1,AS
3,2013,8723,1311,10034,1,AS
4,2013,8760,1359,10119,2,AS
5,2013,8864,1356,10220,2,AS
6,2013,8885,1358,10243,2,AS
7,2013,8884,1365,10249,3,AS
8,2013,8860,1330,10190,3,AS
9,2013,8800,1359,10159,3,AS
10,2013,8815,1360,10175,4,AS
11,2013,8817,1363,10180,4,AS
12,2013,8828,1362,10190,4,AS
1,2014,8843,1349,10192,1,AS
2,2014,8893,1331,10224,1,AS
3,2014,8971,1315,10286,1,AS
4,2014,9123,1303,10426,2,AS
5,2014,9172,1305,10477,2,AS
6,2014,9255,1303,10558,2,AS
7,2014,9332,1313,10645,3,AS
8,2014,9319,1293,10612,3,AS
9,2014,9310,1291,10601,3,AS
10,2014,9432,1315,10747,4,AS
11,2014,9476,1311,10787,4,AS
12,2014,9548,1308,10856,4,AS
1,2015,9555,1294,10849,1,AS
2,2015,9693,1294,10987,1,AS
3,2015,9826,1305,11131,1,AS
4,2015,9929,1315,11244,2,AS
5,2015,10086,1318,11404,2,AS
6,2015,10225,1321,11546,2,AS
7,2015,10209,1324,11533,3,AS
8,2015,10265,1319,11584,3,AS
9,2015,10264,1351,11615,3,AS
10,2015,10266,1366,11632,4,AS
11,2015,10248,1375,11623,4,AS
12,2015,10237,1368,11605,4,AS
1,2016,10264,1383,11647,1,AS
2,2016,10279,1408,11687,1,AS
3,2016,10309,1395,11704,1,AS
4,2016,10358,1376,11734,2,AS
5,2016,10471,1376,11847,2,AS
6,2016,10570,1376,11946,2,AS
7,2016,10569,1368,11937,3,AS
8,2016,10612,1358,11970,3,AS
9,2016,10634,1386,12020,3,AS
10,2016,10747,1403,12150,4,AS
11,2016,10852,1389,12241,4,AS
12,2016,10837,1380,12217,4,AS
1,2017,10914,1400,12314,1,AS
2,2017,11090,1389,12479,1,AS
3,2017,11271,1400,12671,1,AS
4,2017,11474,1404,12878,2,AS
5,2017,11546,1399,12945,2,AS
6,2017,11770,1395,13165,2,AS
7,2017,11896,1409,13305,3,AS
8,2017,12067,1388,13455,3,AS
9,2017,12102,1444,13546,3,AS
10,2017,12259,1505,13764,4,AS
11,2017,12309,1510,13819,4,AS
12,2017,12391,1501,13892,4,AS
1,2018,15486,1937,17423,1,AS
2,2018,15596,1909,17505,1,AS
3,2018,15577,1910,17487,1,AS
4,2018,15693,1920,17613,2,AS
5,2018,15798,1868,17666,2,AS
6,2018,15811,1851,17662,2,AS
7,2018,15837,1826,17663,3,AS
8,2018,15768,1815,17583,3,AS
9,2018,15756,1896,17652,3,AS
10,2018,15774,1890,17664,4,AS
11,2018,15669,1887,17556,4,AS
12,2018,15669,1887,17556,4,AS
1,2019,15608,1894,17502,1,AS
2,2019,15659,1908,17567,1,AS
3,2019,15731,1859,17590,1,AS
4,2019,15773,1847,17620,2,AS
5,2019,15799,1886,17685,2,AS
6,2019,15765,1863,17628,2,AS
7,2019,15976,1839,17815,3,AS
8,2019,15992,1800,17792,3,AS
9,2019,16026,1842,17868,3,AS
10,2019,16022,1858,17880,4,AS
11,2019,16048,1799,17847,4,AS
12,2019,16060,1857,17917,4,AS
1,2020,16086,1853,17939,1,AS
2,2020,16070,1841,17911,1,AS
3,2020,16062,1850,17912,1,AS
4,2020,15840,2010,17850,2,AS
5,2020,15751,2046,17797,2,AS
6,2020,15691,2050,17741,2,AS
7,2020,15631,2009,17640,3,AS
8,2020,15585,1998,17583,3,AS
9,2020,15471,2010,17481,3,AS
10,2020,14683,1964,16647,4,AS
11,2020,14748,1948,16696,4,AS
12,2020,14706,1937,16643,4,AS
1,2021,14861,1875,16736,1,AS
2,2021,14882,1852,16734,1,AS
3,2021,14851,1822,16673,1,AS
4,2021,14810,1821,16631,2,AS
5,2021,14939,1786,16725,2,AS
6,2021,14992,1778,16770,2,AS
7,2021,14993,1758,16751,3,AS
8,2021,15905,1761,17666,3,AS
9,2021,15074,1761,16835,3,AS
10,2021,15230,1737,16967,4,AS
11,2021,15287,1733,17020,4,AS
12,2021,15342,1712,17054,4,AS
1,2022,15500,1701,17201,1,AS
2,2022,15735,1686,17421,1,AS
3,2022,16027,1694,17721,1,AS
4,2022,16436,1715,18151,2,AS
5,2022,16819,1751,18570,2,AS
6,2022,17175,1737,18912,2,AS
7,2022,17549,1722,19271,3,AS
8,2022,19117,220,19337,3,AS
9,2022,17672,1763,19435,3,AS
10,2022,17804,1792,19596,4,AS
11,2022,17836,1802,19638,4,AS
12,2022,17717,1832,19549,4,AS
1,2023,17645,1870,19515,1,AS
2,2023,17745,1889,19634,1,AS
3,2023,17829,1895,19724,1,AS
4,2023,18021,1915,19936,2,AS
5,2023,18074,1913,19987,2,AS
6,2023,18200,1948,20148,2,AS
7,2023,18298,1931,20229,3,AS
8,2023,18246,1927,20173,3,AS
9,2023,18170,2001,20171,3,AS
10,2023,18197,1998,20195,4,AS
11,2023,18179,2007,20186,4,AS
12,2023,18148,1996,20144,4,AS
1,2024,18113,2036,20149,1,AS
2,2024,18065,2065,20130,1,AS
3,2024,17982,2109,20091,1,AS
4,2024,18016,2114,20130,2,AS
5,2024,18068,2164,20232,2,AS
6,2024,18186,2166,20352,2,AS
7,2024,18137,2155,20292,3,AS
8,2024,18077,2143,20220,3,AS
9,2024,18060,2171,20231,3,AS
10,2024,18053,2190,20243,4,AS
11,2024,18109,2154,20263,4,AS
12,2024,18117,2143,20260,4,AS
1,1990,65664,5457,71121,1,UA
2,1990,65839,5446,71285,1,UA
3,1990,66070,5445,71515,1,UA
4,1990,66779,5518,72297,2,UA
5,1990,67217,5675,72892,2,UA
6,1990,67924,5978,73902,2,UA
7,1990,68331,5966,74297,3,UA
8,1990,68431,5992,74423,3,UA
9,1990,68472,5714,74186,3,UA
10,1990,68640,5668,74308,4,UA
11,1990,69091,5681,74772,4,UA
12,1990,69277,5748,75025,4,UA
1,1991,69448,5657,75105,1,UA
2,1991,69460,5661,75121,1,UA
3,1991,70730,5670,76400,1,UA
4,1991,71207,5685,76892,2,UA
5,1991,72036,5835,77871,2,UA
6,1991,72936,6094,79030,2,UA
7,1991,73259,6229,79488,3,UA
8,1991,73749,6266,80015,3,UA
9,1991,73537,6159,79696,3,UA
10,1991,73780,6214,79994,4,UA
11,1991,73987,6235,80222,4,UA
12,1991,74903,6339,81242,4,UA
1,1992,74518,6345,80863,1,UA
2,1992,74660,6241,80901,1,UA
3,1992,74850,6345,81195,1,UA
4,1992,74857,6364,81221,2,UA
5,1992,75012,6510,81522,2,UA
6,1992,75759,6952,82711,2,UA
7,1992,76161,7250,83411,3,UA
8,1992,76233,7230,83463,3,UA
9,1992,75970,7100,83070,3,UA
10,1992,75718,6966,82684,4,UA
11,1992,76335,7122,83457,4,UA
12,1992,76689,7224,83913,4,UA
1,1993,75992,7062,83054,1,UA
2,1993,74760,7120,81880,1,UA
3,1993,74602,7034,81636,1,UA
4,1993,74569,7020,81589,2,UA
5,1993,74654,7296,81950,2,UA
6,1993,75133,7833,82966,2,UA
7,1993,75474,7910,83384,3,UA
8,1993,75303,7882,83185,3,UA
9,1993,74748,7611,82359,3,UA
10,1993,74249,7535,81784,4,UA
11,1993,74138,7539,81677,4,UA
12,1993,73849,7662,81511,4,UA
1,1994,72762,7361,80123,1,UA
2,1994,71144,6869,78013,1,UA
3,1994,69599,6703,76302,1,UA
4,1994,69068,6787,75855,2,UA
5,1994,68361,6791,75152,2,UA
6,1994,68307,7013,75320,2,UA
7,1994,68172,7199,75371,3,UA
8,1994,67891,7265,75156,3,UA
9,1994,67925,7079,75004,3,UA
10,1994,67565,7351,74916,4,UA
11,1994,67775,7499,75274,4,UA
12,1994,68135,7933,76068,4,UA
1,1995,68357,7734,76091,1,UA
2,1995,69112,7765,76877,1,UA
3,1995,70053,7821,77874,1,UA
4,1995,70365,7937,78302,2,UA
5,1995,71144,8021,79165,2,UA
6,1995,72198,8704,80902,2,UA
7,1995,72536,8843,81379,3,UA
8,1995,72536,8906,81442,3,UA
9,1995,72450,8686,81136,3,UA
10,1995,72280,9157,81437,4,UA
11,1995,72660,9203,81863,4,UA
12,1995,72880,9280,82160,4,UA
1,1996,73234,9250,82484,1,UA
2,1996,73417,9322,82739,1,UA
3,1996,73896,9245,83141,1,UA
4,1996,74113,9234,83347,2,UA
5,1996,74057,9972,84029,2,UA
6,1996,74361,10257,84618,2,UA
7,1996,74375,10302,84677,3,UA
8,1996,74181,10348,84529,3,UA
9,1996,74292,10238,84530,3,UA
10,1996,74493,10296,84789,4,UA
11,1996,74922,10510,85432,4,UA
12,1996,75244,10764,86008,4,UA
1,1997,75395,10794,86189,1,UA
2,1997,75387,10913,86300,1,UA
3,1997,75655,10788,86443,1,UA
4,1997,75945,10779,86724,2,UA
5,1997,76632,11161,87793,2,UA
6,1997,77563,11376,88939,2,UA
7,1997,78583,11439,90022,3,UA
8,1997,79025,11347,90372,3,UA
9,1997,79145,11179,90324,3,UA
10,1997,79508,11202,90710,4,UA
11,1997,79847,11263,91110,4,UA
12,1997,80439,11282,91721,4,UA
1,1998,80663,11406,92069,1,UA
2,1998,81021,11182,92203,1,UA
3,1998,81460,11121,92581,1,UA
4,1998,81946,11178,93124,2,UA
5,1998,82460,11182,93642,2,UA
6,1998,82684,11380,94064,2,UA
7,1998,82750,11477,94227,3,UA
8,1998,82937,11142,94079,3,UA
9,1998,83218,11052,94270,3,UA
10,1998,83388,11076,94464,4,UA
11,1998,83886,10904,94790,4,UA
12,1998,84009,10894,94903,4,UA
1,1999,84181,10815,94996,1,UA
2,1999,84319,10850,95169,1,UA
3,1999,85113,11126,96239,1,UA
4,1999,85493,11121,96614,2,UA
5,1999,86163,11269,97432,2,UA
6,1999,86841,11454,98295,2,UA
7,1999,87523,11298,98821,3,UA
8,1999,87088,11671,98759,3,UA
9,1999,87201,11689,98890,3,UA
10,1999,87791,11269,99060,4,UA
11,1999,88720,10951,99671,4,UA
12,1999,88896,11020,99916,4,UA
1,2000,88988,10822,99810,1,UA
2,2000,88701,10766,99467,1,UA
3,2000,88663,11102,99765,1,UA
4,2000,88812,11101,99913,2,UA
5,2000,88855,11488,100343,2,UA
6,2000,89668,11205,100873,2,UA
7,2000,90033,11305,101338,3,UA
8,2000,90108,11307,101415,3,UA
9,2000,90064,11389,101453,3,UA
10,2000,90492,10927,101419,4,UA
11,2000,90838,10920,101758,4,UA
12,2000,90398,11416,101814,4,UA
1,2001,90581,11291,101872,1,UA
2,2001,90763,11034,101797,1,UA
3,2001,91041,11005,102046,1,UA
4,2001,91030,10795,101825,2,UA
5,2001,91122,10614,101736,2,UA
6,2001,91956,9915,101871,2,UA
7,2001,91715,9775,101490,3,UA
8,2001,91584,9677,101261,3,UA
9,2001,91019,9633,100652,3,UA
10,2001,89067,9238,98305,4,UA
11,2001,78476,7087,85563,4,UA
12,2001,77465,6648,84113,4,UA
1,2002,77418,6559,83977,1,UA
2,2002,74763,6500,81263,1,UA
3,2002,73934,6211,80145,1,UA
4,2002,75240,6388,81628,2,UA
5,2002,76032,6545,82577,2,UA
6,2002,76288,6694,82982,2,UA
7,2002,76262,6799,83061,3,UA
8,2002,76224,6931,83155,3,UA
9,2002,75656,6930,82586,3,UA
10,2002,74847,6940,81787,4,UA
11,2002,74406,6913,81319,4,UA
12,2002,73495,6917,80412,4,UA
1,2003,71618,6494,78112,1,UA
2,2003,66080,6154,72234,1,UA
3,2003,64125,5918,70043,1,UA
4,2003,64072,5856,69928,2,UA
5,2003,62077,5779,67856,2,UA
6,2003,60436,6363,66799,2,UA
7,2003,57693,6800,64493,3,UA
8,2003,56413,6854,63267,3,UA
9,2003,56133,6952,63085,3,UA
10,2003,55225,6965,62190,4,UA
11,2003,55225,6965,62190,4,UA
12,2003,55214,6964,62178,4,UA
1,2004,55132,6916,62048,1,UA
2,2004,55147,6945,62092,1,UA
3,2004,55144,6945,62089,1,UA
4,2004,55971,6806,62777,2,UA
5,2004,55939,6773,62712,2,UA
6,2004,55858,6788,62646,2,UA
7,2004,55828,6788,62616,3,UA
8,2004,55451,6707,62158,3,UA
9,2004,55144,6691,61835,3,UA
10,2004,54979,6660,61639,4,UA
11,2004,54902,6671,61573,4,UA
12,2004,54460,6632,61092,4,UA
1,2005,53503,6802,60305,1,UA
2,2005,52591,6803,59394,1,UA
3,2005,52489,6819,59308,1,UA
4,2005,52131,6796,58927,2,UA
5,2005,51902,6677,58579,2,UA
6,2005,51301,6719,58020,2,UA
7,2005,51187,6604,57791,3,UA
8,2005,50676,6493,57169,3,UA
9,2005,50720,6392,57112,3,UA
10,2005,50476,6366,56842,4,UA
11,2005,50647,6300,56947,4,UA
12,2005,50474,6243,56717,4,UA
1,2006,50345,6172,56517,1,UA
2,2006,50244,6248,56492,1,UA
3,2006,50343,6176,56519,1,UA
4,2006,50465,6299,56764,2,UA
5,2006,50394,6317,56711,2,UA
6,2006,50039,6270,56309,2,UA
7,2006,49904,6163,56067,3,UA
8,2006,50167,5922,56089,3,UA
9,2006,50004,5799,55803,3,UA
10,2006,49492,5730,55222,4,UA
11,2006,49587,5704,55291,4,UA
12,2006,49484,5711,55195,4,UA
1,2007,49153,5720,54873,1,UA
2,2007,49061,5693,54754,1,UA
3,2007,49088,5624,54712,1,UA
4,2007,49052,5579,54631,2,UA
5,2007,48943,5643,54586,2,UA
6,2007,48950,5649,54599,2,UA
7,2007,48925,5580,54505,3,UA
8,2007,49043,5605,54648,3,UA
9,2007,49378,5516,54894,3,UA
10,2007,49562,5621,55183,4,UA
11,2007,49600,5650,55250,4,UA
12,2007,49619,5631,55250,4,UA
1,2008,49648,5640,55288,1,UA
2,2008,49632,5622,55254,1,UA
3,2008,49954,5708,55662,1,UA
4,2008,49819,5708,55527,2,UA
5,2008,49367,5650,55017,2,UA
6,2008,48789,5668,54457,2,UA
7,2008,48141,5583,53724,3,UA
8,2008,46933,5732,52665,3,UA
9,2008,44911,5650,50561,3,UA
10,2008,44363,5670,50033,4,UA
11,2008,44000,5584,49584,4,UA
12,2008,43010,5561,48571,4,UA
1,2009,43009,5491,48500,1,UA
2,2009,43024,5473,48497,1,UA
3,2009,43011,5468,48479,1,UA
4,2009,43032,5446,48478,2,UA
5,2009,42888,5464,48352,2,UA
6,2009,42539,5363,47902,2,UA
7,2009,42660,5346,48006,3,UA
8,2009,42909,5374,48283,3,UA
9,2009,41661,5380,47041,3,UA
10,2009,41434,5263,46697,4,UA
11,2009,41276,5231,46507,4,UA
12,2009,41342,5196,46538,4,UA
1,2010,41211,5151,46362,1,UA
2,2010,41107,5179,46286,1,UA
3,2010,41160,5155,46315,1,UA
4,2010,41044,5271,46315,2,UA
5,2010,40988,5266,46254,2,UA
6,2010,40944,5306,46250,2,UA
7,2010,41007,5291,46298,3,UA
8,2010,40955,5280,46235,3,UA
9,2010,40895,5318,46213,3,UA
10,2010,40907,5333,46240,4,UA
11,2010,40955,5307,46262,4,UA
12,2010,40955,5307,46262,4,UA
1,2011,40994,5306,46300,1,UA
2,2011,40919,5365,46284,1,UA
3,2011,40928,5312,46240,1,UA
4,2011,40826,5309,46135,2,UA
5,2011,41029,5296,46325,2,UA
6,2011,40522,5259,45781,2,UA
7,2011,40598,5257,45855,3,UA
8,2011,40665,5139,45804,3,UA
9,2011,40801,5057,45858,3,UA
10,2011,41087,5069,46156,4,UA
11,2011,41242,5038,46280,4,UA
12,2011,41410,5080,46490,4,UA
1,2012,75505,11694,87199,1,UA
2,2012,75946,11494,87440,1,UA
3,2012,76442,11370,87812,1,UA
4,2012,76654,11292,87946,2,UA
5,2012,76803,11369,88172,2,UA
6,2012,76892,11346,88238,2,UA
7,2012,76992,11250,88242,3,UA
8,2012,76273,11345,87618,3,UA
9,2012,76436,11401,87837,3,UA
10,2012,76514,11595,88109,4,UA
11,2012,76578,11605,88183,4,UA
12,2012,76581,11604,88185,4,UA
1,2013,76420,11577,87997,1,UA
2,2013,76383,11661,88044,1,UA
3,2013,76530,11709,88239,1,UA
4,2013,76527,11838,88365,2,UA
5,2013,76646,11884,88530,2,UA
6,2013,76551,11893,88444,2,UA
7,2013,76511,11976,88487,3,UA
8,2013,76118,11928,88046,3,UA
9,2013,76032,12100,88132,3,UA
10,2013,76131,12020,88151,4,UA
11,2013,75981,11798,87779,4,UA
12,2013,75554,11628,87182,4,UA
1,2014,75554,11628,87182,1,UA
2,2014,74760,11868,86628,1,UA
3,2014,74779,11830,86609,1,UA
4,2014,74448,11898,86346,2,UA
5,2014,74537,11925,86462,2,UA
6,2014,74162,11667,85829,2,UA
7,2014,74018,11563,85581,3,UA
8,2014,73540,11445,84985,3,UA
9,2014,73363,11401,84764,3,UA
10,2014,72792,11312,84104,4,UA
11,2014,73284,11212,84496,4,UA
12,2014,73254,11161,84415,4,UA
1,2015,72837,11127,83964,1,UA
2,2015,72829,11101,83930,1,UA
3,2015,73133,11099,84232,1,UA
4,2015,73282,11026,84308,2,UA
5,2015,73288,10744,84032,2,UA
6,2015,73486,10573,84059,2,UA
7,2015,73512,10450,83962,3,UA
8,2015,73561,10469,84030,3,UA
9,2015,73106,10587,83693,3,UA
10,2015,73161,10629,83790,4,UA
11,2015,73468,10740,84208,4,UA
12,2015,73578,10559,84137,4,UA
1,2016,73658,10817,84475,1,UA
2,2016,73942,10885,84827,1,UA
3,2016,74637,10879,85516,1,UA
4,2016,74900,10907,85807,2,UA
5,2016,75402,10773,86175,2,UA
6,2016,75849,10693,86542,2,UA
7,2016,76213,10799,87012,3,UA
8,2016,76206,11002,87208,3,UA
9,2016,76204,11144,87348,3,UA
10,2016,76311,11184,87495,4,UA
11,2016,76478,11098,87576,4,UA
12,2016,76641,10981,87622,4,UA
1,2017,76611,11070,87681,1,UA
2,2017,76649,11151,87800,1,UA
3,2017,76911,11226,88137,1,UA
4,2017,77237,11233,88470,2,UA
5,2017,77329,11219,88548,2,UA
6,2017,77349,11146,88495,2,UA
7,2017,77420,11078,88498,3,UA
8,2017,77237,11128,88365,3,UA
9,2017,76929,11350,88279,3,UA
10,2017,76873,11594,88467,4,UA
11,2017,76851,11591,88442,4,UA
12,2017,76873,11501,88374,4,UA
1,2018,76555,11617,88172,1,UA
2,2018,76736,11560,88296,1,UA
3,2018,76755,11403,88158,1,UA
4,2018,77383,11296,88679,2,UA
5,2018,77411,11314,88725,2,UA
6,2018,77707,11151,88858,2,UA
7,2018,77554,11080,88634,3,UA
8,2018,77432,11006,88438,3,UA
9,2018,77329,11194,88523,3,UA
10,2018,77160,11344,88504,4,UA
11,2018,77202,11327,88529,4,UA
12,2018,77369,11168,88537,4,UA
1,2019,77674,11152,88826,1,UA
2,2019,77959,11092,89051,1,UA
3,2019,78247,11289,89536,1,UA
4,2019,78521,11575,90096,2,UA
5,2019,78882,11664,90546,2,UA
6,2019,79178,11674,90852,2,UA
7,2019,79133,11617,90750,3,UA
8,2019,79171,11533,90704,3,UA
9,2019,79224,11643,90867,3,UA
10,2019,79342,11767,91109,4,UA
11,2019,79301,11814,91115,4,UA
12,2019,79745,11701,91446,4,UA
1,2020,80145,11892,92037,1,UA
2,2020,80362,11887,92249,1,UA
3,2020,80239,11324,91563,1,UA
4,2020,78370,8999,87369,2,UA
5,2020,76053,7670,83723,2,UA
6,2020,74779,7449,82228,2,UA
7,2020,71580,7229,78809,3,UA
8,2020,70558,7343,77901,3,UA
9,2020,70310,6911,77221,3,UA
10,2020,54639,7681,62320,4,UA
11,2020,54411,7871,62282,4,UA
12,2020,54725,7860,62585,4,UA
1,2021,61065,8046,69111,1,UA
2,2021,61950,8108,70058,1,UA
3,2021,59166,8125,67291,1,UA
4,2021,59536,8395,67931,2,UA
5,2021,59986,8747,68733,2,UA
6,2021,60215,8881,69096,2,UA
7,2021,61319,8966,70285,3,UA
8,2021,62612,8926,71538,3,UA
9,2021,63810,8829,72639,3,UA
10,2021,63810,8829,72639,4,UA
11,2021,62427,9422,71849,4,UA
12,2021,65022,13318,78340,4,UA
1,2022,66439,12942,79381,1,UA
2,2022,67102,13481,80583,1,UA
3,2022,68150,13774,81924,1,UA
4,2022,69124,14203,83327,2,UA
5,2022,69949,14765,84714,2,UA
6,2022,70959,15077,86036,2,UA
7,2022,71659,15177,86836,3,UA
8,2022,72373,15524,87897,3,UA
9,2022,73076,15868,88944,3,UA
10,2022,74163,16253,90416,4,UA
11,2022,75054,16424,91478,4,UA
12,2022,75612,16233,91845,4,UA
1,2023,76648,16453,93101,1,UA
2,2023,77580,16603,94183,1,UA
3,2023,78778,16694,95472,1,UA
4,2023,79783,16760,96543,2,UA
5,2023,80936,16801,97737,2,UA
6,2023,82153,16678,98831,2,UA
7,2023,83198,16560,99758,3,UA
8,2023,84118,16518,100636,3,UA
9,2023,84747,16625,101372,3,UA
10,2023,85140,16835,101975,4,UA
11,2023,85569,16835,102404,4,UA
12,2023,85926,16649,102575,4,UA
1,2024,86609,16444,103053,1,UA
2,2024,86907,16364,103271,1,UA
3,2024,87257,16525,103782,1,UA
4,2024,87703,16702,104405,2,UA
5,2024,88527,16977,105504,2,UA
6,2024,88519,17080,105599,2,UA
7,2024,88605,17151,105756,3,UA
8,2024,88297,17119,105416,3,UA
9,2024,88473,17391,105864,3,UA
10,2024,88703,17452,106155,4,UA
11,2024,88846,17557,106403,4,UA
12,2024,89302,17487,106789,4,UA
8,1992,105,21,126,3,NK
9,1992,102,21,123,3,NK
10,1992,105,21,126,4,NK
11,1992,106,19,125,4,NK
12,1992,106,19,125,4,NK
1,1993,102,18,120,1,NK
2,1993,102,18,120,1,NK
3,1993,102,18,120,1,NK
4,1993,102,18,120,2,NK
5,1993,155,26,181,2,NK
6,1993,155,26,181,2,NK
7,1993,169,26,195,3,NK
8,1993,114,48,162,3,NK
9,1993,114,48,162,3,NK
10,1993,114,48,162,4,NK
11,1993,114,48,162,4,NK
12,1993,148,48,196,4,NK
1,1994,148,48,196,1,NK
2,1994,148,48,196,1,NK
3,1994,190,25,215,1,NK
4,1994,190,25,215,2,NK
5,1994,190,25,215,2,NK
6,1994,190,25,215,2,NK
7,1994,215,25,240,3,NK
8,1994,215,25,240,3,NK
9,1994,275,25,300,3,NK
10,1994,275,25,300,4,NK
12,1994,280,43,323,4,NK
1,1995,280,43,323,1,NK
2,1995,280,43,323,1,NK
3,1995,309,55,364,1,NK
4,1995,315,58,373,2,NK
5,1995,335,55,390,2,NK
6,1995,355,30,385,2,NK
7,1995,355,30,385,3,NK
8,1995,355,30,385,3,NK
9,1995,370,85,455,3,NK
10,1995,370,85,455,4,NK
11,1995,370,85,455,4,NK
12,1995,370,85,455,4,NK
1,1996,393,40,433,1,NK
2,1996,393,40,433,1,NK
3,1996,393,40,433,1,NK
4,1996,393,40,433,2,NK
5,1996,350,168,518,2,NK
6,1996,420,98,518,2,NK
7,1996,420,98,518,3,NK
8,1996,420,98,518,3,NK
9,1996,424,112,536,3,NK
10,1996,424,112,536,4,NK
11,1996,424,112,536,4,NK
12,1996,420,100,520,4,NK
1,1997,420,100,520,1,NK
2,1997,400,140,540,1,NK
3,1997,400,140,540,1,NK
4,1997,420,100,520,2,NK
5,1997,443,189,632,2,NK
6,1997,508,190,698,2,NK
7,1997,583,146,729,3,NK
8,1997,584,146,730,3,NK
9,1997,602,150,752,3,NK
10,1997,606,151,757,4,NK
11,1997,644,162,806,4,NK
12,1997,636,159,795,4,NK
1,1998,639,159,798,1,NK
2,1998,684,171,855,1,NK
3,1998,717,179,896,1,NK
4,1998,725,181,906,2,NK
5,1998,662,254,916,2,NK
6,1998,700,234,934,2,NK
7,1998,723,267,990,3,NK
8,1998,767,259,1026,3,NK
9,1998,811,254,1065,3,NK
10,1998,822,274,1096,4,NK
11,1998,878,283,1161,4,NK
12,1998,925,271,1196,4,NK
1,1999,869,279,1148,1,NK
2,1999,952,329,1281,1,NK
3,1999,1023,340,1363,1,NK
4,1999,1105,379,1484,2,NK
5,1999,1073,345,1418,2,NK
6,1999,1135,383,1518,2,NK
7,1999,1279,360,1639,3,NK
8,1999,1322,363,1685,3,NK
9,1999,1301,333,1634,3,NK
10,1999,1381,346,1727,4,NK
11,1999,1618,286,1904,4,NK
12,1999,1657,316,1973,4,NK
1,2000,1655,389,2044,1,NK
2,2000,1704,362,2066,1,NK
3,2000,1687,396,2083,1,NK
4,2000,1633,404,2037,2,NK
5,2000,1608,390,1998,2,NK
6,2000,1565,335,1900,2,NK
7,2000,1482,323,1805,3,NK
8,2000,1416,327,1743,3,NK
9,2000,1404,294,1698,3,NK
10,2000,1316,413,1729,4,NK
11,2000,1444,324,1768,4,NK
12,2000,1574,337,1911,4,NK
1,2001,1582,342,1924,1,NK
2,2001,1698,365,2063,1,NK
3,2001,1773,361,2134,1,NK
4,2001,1999,322,2321,2,NK
5,2001,2041,358,2399,2,NK
6,2001,1945,341,2286,2,NK
7,2001,1935,331,2266,3,NK
8,2001,1958,345,2303,3,NK
9,2001,2015,348,2363,3,NK
10,2001,1593,213,1806,4,NK
11,2001,1740,258,1998,4,NK
12,2001,1774,275,2049,4,NK
1,2002,1849,280,2129,1,NK
2,2002,1849,280,2129,1,NK
3,2002,1940,273,2213,1,NK
4,2002,2025,246,2271,2,NK
5,2002,2047,335,2382,2,NK
6,2002,2102,341,2443,2,NK
7,2002,2103,334,2437,3,NK
8,2002,2139,348,2487,3,NK
9,2002,2134,331,2465,3,NK
10,2002,2204,334,2538,4,NK
11,2002,2228,369,2597,4,NK
12,2002,2199,380,2579,4,NK
1,2003,2223,350,2573,1,NK
2,2003,2219,352,2571,1,NK
3,2003,2235,396,2631,1,NK
4,2003,2327,356,2683,2,NK
5,2003,2263,310,2573,2,NK
6,2003,2270,335,2605,2,NK
7,2003,2144,341,2485,3,NK
8,2003,2295,330,2625,3,NK
9,2003,2137,324,2461,3,NK
10,2003,2114,311,2425,4,NK
11,2003,2243,304,2547,4,NK
12,2003,2402,332,2734,4,NK
1,2004,2242,325,2567,1,NK
2,2004,2243,294,2537,1,NK
3,2004,2250,299,2549,1,NK
4,2004,2261,307,2568,2,NK
5,2004,2288,303,2591,2,NK
6,2004,2278,315,2593,2,NK
7,2004,2272,308,2580,3,NK
8,2004,2271,307,2578,3,NK
9,2004,2173,314,2487,3,NK
10,2004,2155,281,2436,4,NK
11,2004,2360,269,2629,4,NK
12,2004,2339,288,2627,4,NK
1,2005,2324,301,2625,1,NK
2,2005,2208,292,2500,1,NK
3,2005,2146,275,2421,1,NK
4,2005,2072,244,2316,2,NK
5,2005,1934,228,2162,2,NK
6,2005,1980,237,2217,2,NK
7,2005,2029,248,2277,3,NK
8,2005,1976,236,2212,3,NK
9,2005,1905,235,2140,3,NK
10,2005,1928,262,2190,4,NK
11,2005,1951,265,2216,4,NK
12,2005,1923,272,2195,4,NK
1,2006,1959,191,2150,1,NK
2,2006,1957,206,2163,1,NK
3,2006,1872,271,2143,1,NK
4,2006,1870,261,2131,2,NK
5,2006,1837,282,2119,2,NK
6,2006,1899,280,2179,2,NK
7,2006,1893,280,2173,3,NK
8,2006,1848,263,2111,3,NK
9,2006,1863,251,2114,3,NK
10,2006,1890,267,2157,4,NK
11,2006,1906,246,2152,4,NK
12,2006,1916,250,2166,4,NK
1,2007,1935,260,2195,1,NK
2,2007,1994,286,2280,1,NK
3,2007,1981,260,2241,1,NK
4,2007,2001,259,2260,2,NK
5,2007,2032,238,2270,2,NK
6,2007,2062,257,2319,2,NK
7,2007,2047,296,2343,3,NK
8,2007,2047,269,2316,3,NK
9,2007,2039,208,2247,3,NK
10,2007,2105,212,2317,4,NK
11,2007,2211,218,2429,4,NK
12,2007,2092,217,2309,4,NK
1,2008,2108,231,2339,1,NK
2,2008,2240,260,2500,1,NK
3,2008,2365,241,2606,1,NK
4,2008,2336,225,2561,2,NK
5,2008,2356,289,2645,2,NK
6,2008,2305,295,2600,2,NK
7,2008,2177,292,2469,3,NK
8,2008,2094,286,2380,3,NK
9,2008,2192,286,2478,3,NK
10,2008,2184,264,2448,4,NK
11,2008,2127,277,2404,4,NK
12,2008,2116,294,2410,4,NK
1,2009,1817,290,2107,1,NK
2,2009,1754,270,2024,1,NK
3,2009,1758,296,2054,1,NK
4,2009,1753,291,2044,2,NK
5,2009,1770,322,2092,2,NK
6,2009,1754,302,2056,2,NK
7,2009,1741,313,2054,3,NK
8,2009,1740,297,2037,3,NK
9,2009,1723,292,2015,3,NK
10,2009,1738,290,2028,4,NK
11,2009,1736,340,2076,4,NK
12,2009,1751,338,2089,4,NK
1,2010,1797,336,2133,1,NK
2,2010,1783,336,2119,1,NK
3,2010,1842,364,2206,1,NK
4,2010,1783,336,2119,2,NK
5,2010,1871,379,2250,2,NK
6,2010,1881,343,2224,2,NK
7,2010,1883,339,2222,3,NK
8,2010,1884,339,2223,3,NK
9,2010,2013,348,2361,3,NK
10,2010,1954,333,2287,4,NK
11,2010,1955,376,2331,4,NK
12,2010,2001,393,2394,4,NK
1,2011,2045,396,2441,1,NK
2,2011,2045,396,2441,1,NK
3,2011,1975,328,2303,1,NK
4,2011,2080,401,2481,2,NK
5,2011,2093,411,2504,2,NK
6,2011,2129,410,2539,2,NK
7,2011,2122,421,2543,3,NK
8,2011,2126,421,2547,3,NK
9,2011,2173,396,2569,3,NK
10,2011,2208,385,2593,4,NK
11,2011,2222,419,2641,4,NK
12,2011,2398,669,3067,4,NK
1,2012,2316,439,2755,1,NK
2,2012,2409,441,2850,1,NK
3,2012,2507,526,3033,1,NK
4,2012,2458,468,2926,2,NK
5,2012,2497,455,2952,2,NK
6,2012,2539,462,3001,2,NK
7,2012,2548,531,3079,3,NK
8,2012,3137,474,3611,3,NK
9,2012,2566,487,3053,3,NK
10,2012,2579,466,3045,4,NK
11,2012,2660,456,3116,4,NK
12,2012,3008,717,3725,4,NK
1,2013,2767,450,3217,1,NK
2,2013,2798,456,3254,1,NK
3,2013,2962,506,3468,1,NK
4,2013,2932,454,3386,2,NK
5,2013,3027,457,3484,2,NK
6,2013,3162,476,3638,2,NK
7,2013,3107,459,3566,3,NK
8,2013,3137,474,3611,3,NK
9,2013,3165,447,3612,3,NK
10,2013,3262,450,3712,4,NK
11,2013,3293,455,3748,4,NK
12,2013,3320,445,3765,4,NK
1,2014,3374,460,3834,1,NK
2,2014,3312,444,3756,1,NK
3,2014,3339,459,3798,1,NK
4,2014,3415,473,3888,2,NK
5,2014,3437,461,3898,2,NK
6,2014,3484,459,3943,2,NK
7,2014,3507,471,3978,3,NK
8,2014,3538,471,4009,3,NK
9,2014,3573,460,4033,3,NK
10,2014,3612,494,4106,4,NK
11,2014,4195,503,4698,4,NK
12,2014,3685,479,4164,4,NK
1,2015,3766,534,4300,1,NK
2,2015,3825,507,4332,1,NK
3,2015,3899,520,4419,1,NK
4,2015,3982,463,4445,2,NK
5,2015,4028,398,4426,2,NK
6,2015,4115,377,4492,2,NK
7,2015,4166,289,4455,3,NK
8,2015,4270,279,4549,3,NK
9,2015,4312,276,4588,3,NK
10,2015,4394,271,4665,4,NK
11,2015,4490,265,4755,4,NK
12,2015,4567,269,4836,4,NK
1,2016,4673,270,4943,1,NK
2,2016,4781,269,5050,1,NK
3,2016,4796,294,5090,1,NK
4,2016,4905,288,5193,2,NK
5,2016,5122,309,5431,2,NK
6,2016,5111,292,5403,2,NK
7,2016,5152,286,5438,3,NK
8,2016,5192,286,5478,3,NK
9,2016,5261,271,5532,3,NK
10,2016,5274,267,5541,4,NK
11,2016,5330,308,5638,4,NK
12,2016,5437,319,5756,4,NK
1,2017,5484,315,5799,1,NK
2,2017,5496,312,5808,1,NK
3,2017,5598,367,5965,1,NK
4,2017,5661,376,6037,2,NK
5,2017,5772,362,6134,2,NK
6,2017,5944,373,6317,2,NK
7,2017,6031,371,6402,3,NK
8,2017,6025,368,6393,3,NK
9,2017,6144,357,6501,3,NK
10,2017,6203,389,6592,4,NK
11,2017,6317,376,6693,4,NK
12,2017,6406,388,6794,4,NK
1,2018,6483,388,6871,1,NK
2,2018,6571,391,6962,1,NK
3,2018,6699,405,7104,1,NK
4,2018,6874,387,7261,2,NK
5,2018,6971,333,7304,2,NK
6,2018,7043,332,7375,2,NK
7,2018,7026,334,7360,3,NK
8,2018,7127,343,7470,3,NK
9,2018,7242,280,7522,3,NK
10,2018,7401,296,7697,4,NK
11,2018,7318,299,7617,4,NK
12,2018,7343,305,7648,4,NK
1,2019,7406,294,7700,1,NK
2,2019,7489,296,7785,1,NK
3,2019,7570,305,7875,1,NK
4,2019,7600,328,7928,2,NK
5,2019,7741,340,8081,2,NK
6,2019,7884,348,8232,2,NK
7,2019,7870,338,8208,3,NK
8,2019,7917,363,8280,3,NK
9,2019,8000,342,8342,3,NK
10,2019,8103,342,8445,4,NK
11,2019,8273,395,8668,4,NK
12,2019,8607,386,8993,4,NK
1,2020,8467,372,8839,1,NK
2,2020,8600,375,8975,1,NK
3,2020,8858,355,9213,1,NK
4,2020,8864,340,9204,2,NK
5,2020,8868,331,9199,2,NK
6,2020,8807,327,9134,2,NK
7,2020,8817,327,9144,3,NK
8,2020,8636,290,8926,3,NK
9,2020,8617,276,8893,3,NK
10,2020,8606,323,8929,4,NK
11,2020,8612,299,8911,4,NK
12,2020,8851,324,9175,4,NK
1,2021,8497,330,8827,1,NK
2,2021,8448,317,8765,1,NK
3,2021,8496,324,8820,1,NK
4,2021,8539,333,8872,2,NK
5,2021,8741,304,9045,2,NK
6,2021,8949,311,9260,2,NK
7,2021,9031,285,9316,3,NK
8,2021,9165,294,9459,3,NK
9,2021,9310,284,9594,3,NK
10,2021,9563,268,9831,4,NK
11,2021,9663,249,9912,4,NK
12,2021,10148,285,10433,4,NK
1,2022,9918,307,10225,1,NK
2,2022,9970,326,10296,1,NK
3,2022,10144,342,10486,1,NK
4,2022,10321,337,10658,2,NK
5,2022,10454,333,10787,2,NK
6,2022,10588,333,10921,2,NK
7,2022,10713,307,11020,3,NK
8,2022,10974,302,11276,3,NK
9,2022,11185,332,11517,3,NK
10,2022,11397,310,11707,4,NK
11,2022,11377,318,11695,4,NK
12,2022,11654,297,11951,4,NK
1,2023,11865,311,12176,1,NK
2,2023,11988,310,12298,1,NK
3,2023,12211,344,12555,1,NK
4,2023,12273,325,12598,2,NK
5,2023,12376,320,12696,2,NK
6,2023,12507,322,12829,2,NK
7,2023,12622,333,12955,3,NK
8,2023,12808,313,13121,3,NK
9,2023,12811,360,13171,3,NK
10,2023,12809,325,13134,4,NK
11,2023,12819,343,13162,4,NK
12,2023,13484,345,13829,4,NK
1,2024,12829,374,13203,1,NK
2,2024,12503,355,12858,1,NK
3,2024,12322,438,12760,1,NK
4,2024,12069,387,12456,2,NK
5,2024,12028,401,12429,2,NK
6,2024,11880,389,12269,2,NK
7,2024,11739,400,12139,3,NK
8,2024,11825,435,12260,3,NK
9,2024,11772,411,12183,3,NK
10,2024,11357,403,11760,4,NK
11,2024,11262,393,11655,4,NK
12,2024,11787,404,12191,4,NK
1,1990,6997,832,7829,1,WN
2,1990,6996,833,7829,1,WN
3,1990,7090,833,7923,1,WN
4,1990,7772,173,7945,2,WN
5,1990,8049,164,8213,2,WN
6,1990,8224,165,8389,2,WN
7,1990,8297,157,8454,3,WN
8,1990,8310,150,8460,3,WN
9,1990,8325,152,8477,3,WN
10,1990,8416,142,8558,4,WN
11,1990,8463,137,8600,4,WN
12,1990,8486,134,8620,4,WN
1,1991,8503,137,8640,1,WN
2,1991,8667,134,8801,1,WN
3,1991,8671,135,8806,1,WN
4,1991,8892,134,9026,2,WN
5,1991,9074,136,9210,2,WN
6,1991,9170,131,9301,2,WN
7,1991,9249,130,9379,3,WN
8,1991,9312,114,9426,3,WN
9,1991,9396,111,9507,3,WN
10,1991,9462,101,9563,4,WN
11,1991,9570,111,9681,4,WN
12,1991,9687,91,9778,4,WN
1,1992,9784,83,9867,1,WN
2,1992,9902,91,9993,1,WN
3,1992,10152,86,10238,1,WN
4,1992,10520,85,10605,2,WN
5,1992,10702,80,10782,2,WN
6,1992,10709,73,10782,2,WN
7,1992,11277,73,11350,3,WN
8,1992,11329,73,11402,3,WN
9,1992,11373,67,11440,3,WN
10,1992,11520,66,11586,4,WN
11,1992,11563,60,11623,4,WN
12,1992,11453,56,11509,4,WN
1,1993,11491,56,11547,1,WN
2,1993,11675,57,11732,1,WN
3,1993,11835,55,11890,1,WN
4,1993,12101,55,12156,2,WN
5,1993,12357,53,12410,2,WN
6,1993,12541,54,12595,2,WN
7,1993,12766,53,12819,3,WN
8,1993,12844,54,12898,3,WN
9,1993,12948,50,12998,3,WN
10,1993,12967,49,13016,4,WN
11,1993,13174,53,13227,4,WN
12,1993,13232,52,13284,4,WN
1,1994,13267,50,13317,1,WN
2,1994,13407,52,13459,1,WN
3,1994,13730,48,13778,1,WN
4,1994,13833,45,13878,2,WN
5,1994,14747,46,14793,2,WN
6,1994,14992,47,15039,2,WN
7,1994,15260,48,15308,3,WN
8,1994,15482,50,15532,3,WN
9,1994,15793,46,15839,3,WN
10,1994,16125,50,16175,4,WN
11,1994,16369,47,16416,4,WN
12,1994,16597,49,16646,4,WN
1,1995,17089,46,17135,1,WN
2,1995,17524,47,17571,1,WN
3,1995,17970,45,18015,1,WN
4,1995,18271,43,18314,2,WN
5,1995,18488,41,18529,2,WN
6,1995,18944,42,18986,2,WN
7,1995,19101,195,19296,3,WN
8,1995,19181,320,19501,3,WN
9,1995,19270,478,19748,3,WN
10,1995,19337,577,19914,4,WN
11,1995,19454,635,20089,4,WN
12,1995,19546,774,20320,4,WN
1,1996,19880,684,20564,1,WN
2,1996,20008,668,20676,1,WN
3,1996,20477,653,21130,1,WN
4,1996,20889,670,21559,2,WN
5,1996,21245,665,21910,2,WN
6,1996,21526,762,22288,2,WN
7,1996,21757,816,22573,3,WN
8,1996,21821,828,22649,3,WN
9,1996,22624,884,23508,3,WN
10,1996,22457,862,23319,4,WN
11,1996,22534,904,23438,4,WN
12,1996,22493,902,23395,4,WN
1,1997,22839,887,23726,1,WN
2,1997,23027,880,23907,1,WN
3,1997,23544,436,23980,1,WN
4,1997,23227,849,24076,2,WN
5,1997,23265,876,24141,2,WN
6,1997,23329,897,24226,2,WN
7,1997,23394,911,24305,3,WN
8,1997,23358,895,24253,3,WN
9,1997,23407,866,24273,3,WN
10,1997,23385,886,24271,4,WN
11,1997,23568,955,24523,4,WN
12,1997,23494,960,24454,4,WN
1,1998,23570,890,24460,1,WN
2,1998,23526,850,24376,1,WN
3,1998,23729,844,24573,1,WN
4,1998,23805,827,24632,2,WN
5,1998,23833,818,24651,2,WN
6,1998,23967,840,24807,2,WN
7,1998,24155,809,24964,3,WN
8,1998,24885,405,25290,3,WN
9,1998,24610,818,25428,3,WN
10,1998,24898,819,25717,4,WN
11,1998,25198,890,26088,4,WN
12,1998,25392,904,26296,4,WN
1,1999,25424,857,26281,1,WN
2,1999,26280,884,27164,1,WN
3,1999,26104,857,26961,1,WN
4,1999,26009,837,26846,2,WN
5,1999,26179,857,27036,2,WN
6,1999,26386,864,27250,2,WN
7,1999,26681,880,27561,3,WN
8,1999,26804,864,27668,3,WN
9,1999,26742,845,27587,3,WN
10,1999,27049,862,27911,4,WN
11,1999,27200,878,28078,4,WN
12,1999,27211,884,28095,4,WN
1,2000,27316,854,28170,1,WN
2,2000,27500,840,28340,1,WN
3,2000,27481,860,28341,1,WN
4,2000,27601,858,28459,2,WN
5,2000,27514,852,28366,2,WN
6,2000,27403,850,28253,2,WN
7,2000,27593,878,28471,3,WN
8,2000,27821,826,28647,3,WN
9,2000,27916,810,28726,3,WN
10,2000,28329,830,29159,4,WN
11,2000,28626,829,29455,4,WN
12,2000,28860,828,29688,4,WN
1,2001,28887,813,29700,1,WN
2,2001,29060,810,29870,1,WN
3,2001,29160,800,29960,1,WN
4,2001,29498,793,30291,2,WN
5,2001,29781,779,30560,2,WN
6,2001,29996,746,30742,2,WN
7,2001,30367,748,31115,3,WN
8,2001,30478,731,31209,3,WN
9,2001,30580,733,31313,3,WN
10,2001,30749,739,31488,4,WN
11,2001,31049,728,31777,4,WN
12,2001,31945,729,32674,4,WN
1,2002,31282,725,32007,1,WN
2,2002,31538,720,32258,1,WN
3,2002,31875,739,32614,1,WN
4,2002,32316,742,33058,2,WN
5,2002,32351,726,33077,2,WN
6,2002,32790,718,33508,2,WN
7,2002,33151,732,33883,3,WN
8,2002,33261,726,33987,3,WN
9,2002,33271,676,33947,3,WN
10,2002,33347,722,34069,4,WN
11,2002,33800,742,34542,4,WN
12,2002,33322,766,34088,4,WN
1,2003,33062,730,33792,1,WN
2,2003,33141,771,33912,1,WN
3,2003,32776,728,33504,1,WN
4,2003,32692,761,33453,2,WN
5,2003,32612,794,33406,2,WN
6,2003,32481,842,33323,2,WN
7,2003,32636,852,33488,3,WN
8,2003,32307,855,33162,3,WN
9,2003,32146,834,32980,3,WN
10,2003,32164,858,33022,4,WN
11,2003,32334,905,33239,4,WN
12,2003,32394,906,33300,4,WN
1,2004,32054,859,32913,1,WN
2,2004,31257,708,31965,1,WN
3,2004,31202,640,31842,1,WN
4,2004,31219,624,31843,2,WN
5,2004,31091,622,31713,2,WN
6,2004,31081,655,31736,2,WN
7,2004,31317,718,32035,3,WN
8,2004,30615,539,31154,3,WN
9,2004,30387,540,30927,3,WN
10,2004,30399,529,30928,4,WN
11,2004,31245,535,31780,4,WN
12,2004,30749,525,31274,4,WN
1,2005,30753,515,31268,1,WN
2,2005,30685,498,31183,1,WN
3,2005,30728,493,31221,1,WN
4,2005,30813,489,31302,2,WN
5,2005,30995,493,31488,2,WN
6,2005,31110,512,31622,2,WN
7,2005,31176,504,31680,3,WN
8,2005,31214,497,31711,3,WN
9,2005,31134,496,31630,3,WN
10,2005,31013,503,31516,4,WN
11,2005,31393,507,31900,4,WN
12,2005,31472,514,31986,4,WN
1,2006,31177,506,31683,1,WN
2,2006,31210,504,31714,1,WN
3,2006,31142,509,31651,1,WN
4,2006,31377,502,31879,2,WN
5,2006,31433,502,31935,2,WN
6,2006,31482,505,31987,2,WN
7,2006,31477,507,31984,3,WN
8,2006,31849,491,32340,3,WN
9,2006,31903,482,32385,3,WN
10,2006,32238,479,32717,4,WN
11,2006,32354,479,32833,4,WN
12,2006,32429,470,32899,4,WN
1,2007,32255,470,32725,1,WN
2,2007,32594,470,33064,1,WN
3,2007,32728,467,33195,1,WN
4,2007,32891,479,33370,2,WN
5,2007,32993,474,33467,2,WN
6,2007,33023,475,33498,2,WN
7,2007,33309,490,33799,3,WN
8,2007,33400,477,33877,3,WN
9,2007,33544,485,34029,3,WN
10,2007,33620,511,34131,4,WN
11,2007,33845,516,34361,4,WN
12,2007,34105,545,34650,4,WN
1,2008,33910,552,34462,1,WN
2,2008,33794,552,34346,1,WN
3,2008,33567,655,34222,1,WN
4,2008,33729,655,34384,2,WN
5,2008,33576,666,34242,2,WN
6,2008,33681,692,34373,2,WN
7,2008,33925,719,34644,3,WN
8,2008,34971,673,35644,3,WN
9,2008,35194,701,35895,3,WN
10,2008,35321,687,36008,4,WN
11,2008,35313,710,36023,4,WN
12,2008,35146,706,35852,4,WN
1,2009,35167,712,35879,1,WN
2,2009,35187,711,35898,1,WN
3,2009,35154,715,35869,1,WN
4,2009,35078,723,35801,2,WN
5,2009,35049,723,35772,2,WN
6,2009,34938,716,35654,2,WN
7,2009,34580,701,35281,3,WN
8,2009,34324,672,34996,3,WN
9,2009,34477,657,35134,3,WN
10,2009,34420,656,35076,4,WN
11,2009,34439,642,35081,4,WN
12,2009,34409,633,35042,4,WN
1,2010,34475,632,35107,1,WN
2,2010,34424,612,35036,1,WN
3,2010,34327,619,34946,1,WN
4,2010,34278,588,34866,2,WN
5,2010,34309,607,34916,2,WN
6,2010,34309,653,34962,2,WN
7,2010,34313,688,35001,3,WN
8,2010,34410,715,35125,3,WN
9,2010,34482,707,35189,3,WN
10,2010,34621,737,35358,4,WN
11,2010,34614,781,35395,4,WN
12,2010,34506,790,35296,4,WN
1,2011,34740,806,35546,1,WN
2,2011,34977,759,35736,1,WN
3,2011,35065,773,35838,1,WN
4,2011,35260,767,36027,2,WN
5,2011,35489,786,36275,2,WN
6,2011,35835,794,36629,2,WN
7,2011,36054,827,36881,3,WN
8,2011,36322,830,37152,3,WN
9,2011,36711,833,37544,3,WN
10,2011,36939,820,37759,4,WN
11,2011,37167,850,38017,4,WN
12,2011,37202,877,38079,4,WN
1,2012,37741,923,38664,1,WN
2,2012,37990,955,38945,1,WN
3,2012,38336,993,39329,1,WN
4,2012,45405,1437,46842,2,WN
5,2012,45438,1476,46914,2,WN
6,2012,45391,1473,46864,2,WN
7,2012,45208,1490,46698,3,WN
8,2012,45016,1466,46482,3,WN
9,2012,45301,1494,46795,3,WN
10,2012,45277,1476,46753,4,WN
11,2012,45204,1497,46701,4,WN
12,2012,45128,1466,46594,4,WN
1,2013,45121,1428,46549,1,WN
2,2013,45145,1424,46569,1,WN
3,2013,45078,1426,46504,1,WN
4,2013,44860,1459,46319,2,WN
5,2013,44796,1404,46200,2,WN
6,2013,44543,1345,45888,2,WN
7,2013,44464,1328,45792,3,WN
8,2013,44327,1345,45672,3,WN
9,2013,44476,1343,45819,3,WN
10,2013,44391,1366,45757,4,WN
11,2013,44246,1330,45576,4,WN
12,2013,44158,1346,45504,4,WN
1,2014,44318,1329,45647,1,WN
2,2014,44430,1321,45751,1,WN
3,2014,44492,1341,45833,1,WN
4,2014,44533,1368,45901,2,WN
5,2014,44653,1377,46030,2,WN
6,2014,44814,1388,46202,2,WN
7,2014,44815,1415,46230,3,WN
8,2014,44871,1396,46267,3,WN
9,2014,45020,1459,46479,3,WN
10,2014,45349,1492,46841,4,WN
11,2014,45552,1494,47046,4,WN
12,2014,45533,1490,47023,4,WN
1,2015,45840,1495,47335,1,WN
2,2015,46016,1536,47552,1,WN
3,2015,46219,1571,47790,1,WN
4,2015,46363,1631,47994,2,WN
5,2015,46678,1635,48313,2,WN
6,2015,46808,1674,48482,2,WN
7,2015,47054,1642,48696,3,WN
8,2015,47329,1679,49008,3,WN
9,2015,47774,1736,49510,3,WN
10,2015,48313,1707,50020,4,WN
11,2015,48744,1668,50412,4,WN
12,2015,48757,1652,50409,4,WN
1,2016,49127,1707,50834,1,WN
2,2016,49575,1747,51322,1,WN
3,2016,50021,1779,51800,1,WN
4,2016,50558,1770,52328,2,WN
5,2016,50985,1805,52790,2,WN
6,2016,51413,1775,53188,2,WN
7,2016,51650,1789,53439,3,WN
8,2016,51920,1837,53757,3,WN
9,2016,52122,1899,54021,3,WN
10,2016,52504,1952,54456,4,WN
11,2016,52727,1902,54629,4,WN
12,2016,52620,1831,54451,4,WN
1,2017,53120,1861,54981,1,WN
2,2017,53622,1858,55480,1,WN
3,2017,53726,1852,55578,1,WN
4,2017,53910,1851,55761,2,WN
5,2017,54190,1850,56040,2,WN
6,2017,54439,1816,56255,2,WN
7,2017,54455,1801,56256,3,WN
8,2017,54503,1862,56365,3,WN
9,2017,54730,1882,56612,3,WN
10,2017,55068,1839,56907,4,WN
11,2017,55103,1927,57030,4,WN
12,2017,55143,1934,57077,4,WN
1,2018,55486,2081,57567,1,WN
2,2018,55776,2117,57893,1,WN
3,2018,56036,2152,58188,1,WN
4,2018,56367,2232,58599,2,WN
5,2018,56614,2218,58832,2,WN
6,2018,56550,2248,58798,2,WN
7,2018,56678,2375,59053,3,WN
8,2018,56928,2414,59342,3,WN
9,2018,57369,2380,59749,3,WN
10,2018,57599,2376,59975,4,WN
11,2018,57679,2346,60025,4,WN
12,2018,57624,2358,59982,4,WN
1,2019,57902,2361,60263,1,WN
2,2019,58156,2292,60448,1,WN
3,2019,58312,2247,60559,1,WN
4,2019,58474,2255,60729,2,WN
5,2019,58517,2240,60757,2,WN
6,2019,58698,2190,60888,2,WN
7,2019,58873,2184,61057,3,WN
8,2019,59053,2235,61288,3,WN
9,2019,59453,2274,61727,3,WN
10,2019,59657,2308,61965,4,WN
11,2019,59605,2282,61887,4,WN
12,2019,59629,2276,61905,4,WN
1,2020,59914,2302,62216,1,WN
2,2020,60092,2344,62436,1,WN
3,2020,59763,2318,62081,1,WN
4,2020,59866,2325,62191,2,WN
5,2020,60012,2333,62345,2,WN
6,2020,59947,2341,62288,2,WN
7,2020,59726,2318,62044,3,WN
8,2020,59355,2333,61688,3,WN
9,2020,56834,2194,59028,3,WN
10,2020,55992,2142,58134,4,WN
11,2020,55845,2109,57954,4,WN
12,2020,55500,2074,57574,4,WN
1,2021,55370,2055,57425,1,WN
2,2021,55325,2019,57344,1,WN
3,2021,55065,1972,57037,1,WN
4,2021,54761,1919,56680,2,WN
5,2021,54191,1832,56023,2,WN
6,2021,53602,1691,55293,2,WN
7,2021,53197,1615,54812,3,WN
8,2021,53039,1473,54512,3,WN
9,2021,53269,1429,54698,3,WN
10,2021,53367,1381,54748,4,WN
11,2021,53926,1335,55261,4,WN
12,2021,54439,1307,55746,4,WN
1,2022,55602,1276,56878,1,WN
2,2022,56945,1240,58185,1,WN
3,2022,58270,1189,59459,1,WN
4,2022,59705,1212,60917,2,WN
5,2022,60737,1303,62040,2,WN
6,2022,61619,1428,63047,2,WN
7,2022,62448,1570,64018,3,WN
8,2022,62677,1673,64350,3,WN
9,2022,63238,1770,65008,3,WN
10,2022,64297,1818,66115,4,WN
11,2022,65424,1632,67056,4,WN
12,2022,65881,1549,67430,4,WN
1,2023,66965,1523,68488,1,WN
2,2023,68154,1468,69622,1,WN
3,2023,69137,1462,70599,1,WN
4,2023,69770,1526,71296,2,WN
5,2023,70132,1455,71587,2,WN
6,2023,70590,1417,72007,2,WN
7,2023,71846,1349,73195,3,WN
8,2023,72659,1340,73999,3,WN
9,2023,73480,1401,74881,3,WN
10,2023,73998,1371,75369,4,WN
11,2023,74294,1384,75678,4,WN
12,2023,74046,1519,75565,4,WN
1,2024,74033,1672,75705,1,WN
2,2024,73967,1780,75747,1,WN
3,2024,73734,1921,75655,1,WN
4,2024,73783,2128,75911,2,WN
5,2024,73462,2155,75617,2,WN
6,2024,72946,2270,75216,2,WN
7,2024,72564,2333,74897,3,WN
8,2024,72299,2311,74610,3,WN
9,2024,72276,2374,74650,3,WN
10,2024,72259,2555,74814,4,WN
11,2024,71877,2557,74434,4,WN
12,2024,71206,2487,73693,4,WN
2,2000,275,175,450,1,B6
3,2000,310,195,505,1,B6
4,2000,360,210,570,2,B6
5,2000,424,161,585,2,B6
6,2000,452,176,628,2,B6
7,2000,532,186,718,3,B6
8,2000,590,227,817,3,B6
9,2000,689,258,947,3,B6
10,2000,764,277,1041,4,B6
11,2000,796,189,985,4,B6
12,2000,833,325,1158,4,B6
1,2001,967,373,1340,1,B6
2,2001,1123,393,1516,1,B6
3,2001,1137,384,1521,1,B6
4,2001,1214,392,1606,2,B6
5,2001,1221,452,1673,2,B6
6,2001,1272,498,1770,2,B6
7,2001,1345,524,1869,3,B6
8,2001,1407,560,1967,3,B6
9,2001,1509,556,2065,3,B6
10,2001,1551,598,2149,4,B6
11,2001,1644,626,2270,4,B6
12,2001,1700,661,2361,4,B6
1,2002,1927,645,2572,1,B6
2,2002,2030,613,2643,1,B6
3,2002,2145,604,2749,1,B6
4,2002,2271,637,2908,2,B6
5,2002,2349,645,2994,2,B6
6,2002,2455,638,3093,2,B6
7,2002,2607,703,3310,3,B6
8,2002,2697,751,3448,3,B6
9,2002,2884,730,3614,3,B6
10,2002,3152,638,3790,4,B6
11,2002,3275,683,3958,4,B6
12,2002,3359,652,4011,4,B6
1,2003,3538,755,4293,1,B6
2,2003,3639,444,4083,1,B6
3,2003,3679,731,4410,1,B6
4,2003,3870,742,4612,2,B6
5,2003,4123,743,4866,2,B6
6,2003,4057,780,4837,2,B6
7,2003,4108,801,4909,3,B6
8,2003,4232,784,5016,3,B6
9,2003,4393,813,5206,3,B6
10,2003,4491,863,5354,4,B6
11,2003,4779,828,5607,4,B6
12,2003,4704,849,5553,4,B6
1,2004,4810,875,5685,1,B6
2,2004,4861,918,5779,1,B6
3,2004,5021,945,5966,1,B6
4,2004,5074,970,6044,2,B6
5,2004,5208,1059,6267,2,B6
6,2004,5340,1116,6456,2,B6
7,2004,5477,1149,6626,3,B6
8,2004,5600,1205,6805,3,B6
9,2004,5603,1305,6908,3,B6
10,2004,5758,1336,7094,4,B6
11,2004,5900,1414,7314,4,B6
12,2004,5956,1443,7399,4,B6
1,2005,6131,1436,7567,1,B6
2,2005,6160,1422,7582,1,B6
3,2005,6287,1412,7699,1,B6
4,2005,6363,1435,7798,2,B6
5,2005,6507,1482,7989,2,B6
6,2005,6741,1527,8268,2,B6
7,2005,6885,1577,8462,3,B6
8,2005,6979,1520,8499,3,B6
9,2005,7109,1551,8660,3,B6
10,2005,7336,1593,8929,4,B6
11,2005,7490,1614,9104,4,B6
12,2005,7647,1601,9248,4,B6
1,2006,7930,1763,9693,1,B6
2,2006,8045,1827,9872,1,B6
3,2006,8233,2015,10248,1,B6
4,2006,8415,2065,10480,2,B6
5,2006,8551,2058,10609,2,B6
6,2006,8646,2058,10704,2,B6
7,2006,8663,2026,10689,3,B6
8,2006,8580,2041,10621,3,B6
9,2006,8568,2104,10672,3,B6
10,2006,8521,2168,10689,4,B6
11,2006,8465,2219,10684,4,B6
12,2006,8393,2231,10624,4,B6
1,2007,8378,2320,10698,1,B6
2,2007,8329,2276,10605,1,B6
3,2007,8418,2268,10686,1,B6
4,2007,8402,2364,10766,2,B6
5,2007,8360,2479,10839,2,B6
6,2007,8375,2599,10974,2,B6
7,2007,8351,2507,10858,3,B6
8,2007,8320,2577,10897,3,B6
9,2007,8331,2643,10974,3,B6
10,2007,8410,2788,11198,4,B6
11,2007,8707,2811,11518,4,B6
12,2007,8721,2847,11568,4,B6
1,2008,8918,2959,11877,1,B6
2,2008,8942,3007,11949,1,B6
3,2008,9000,3026,12026,1,B6
4,2008,9115,3039,12154,2,B6
5,2008,9111,2999,12110,2,B6
6,2008,9056,2934,11990,2,B6
7,2008,8969,2909,11878,3,B6
8,2008,8902,2877,11779,3,B6
9,2008,8834,2928,11762,3,B6
10,2008,8886,2947,11833,4,B6
11,2008,8901,2991,11892,4,B6
12,2008,8902,2950,11852,4,B6
1,2009,9019,2995,12014,1,B6
2,2009,9047,2983,12030,1,B6
3,2009,9027,2995,12022,1,B6
4,2009,9194,3138,12332,2,B6
5,2009,9200,3139,12339,2,B6
6,2009,9202,3147,12349,2,B6
7,2009,9157,3246,12403,3,B6
8,2009,9260,3323,12583,3,B6
9,2009,9115,3325,12440,3,B6
10,2009,9146,3310,12456,4,B6
11,2009,9182,3328,12510,4,B6
12,2009,9180,3352,12532,4,B6
1,2010,9371,3207,12578,1,B6
2,2010,9567,3268,12835,1,B6
3,2010,9667,3133,12800,1,B6
4,2010,9651,3097,12748,2,B6
5,2010,9698,3150,12848,2,B6
6,2010,9622,3223,12845,2,B6
7,2010,9620,3206,12826,3,B6
8,2010,9539,3223,12762,3,B6
9,2010,9482,3236,12718,3,B6
10,2010,9568,3353,12921,4,B6
11,2010,9606,3357,12963,4,B6
12,2010,9626,3322,12948,4,B6
1,2011,9720,3404,13124,1,B6
2,2011,9741,3433,13174,1,B6
3,2011,9851,3440,13291,1,B6
4,2011,9977,3535,13512,2,B6
5,2011,10104,3537,13641,2,B6
6,2011,10217,3597,13814,2,B6
7,2011,10150,3572,13722,3,B6
8,2011,10155,3526,13681,3,B6
9,2011,10146,3638,13784,3,B6
10,2011,10236,3743,13979,4,B6
11,2011,10240,3725,13965,4,B6
12,2011,10243,3779,14022,4,B6
1,2012,10467,3765,14232,1,B6
2,2012,10555,3807,14362,1,B6
3,2012,10606,3829,14435,1,B6
4,2012,10664,3860,14524,2,B6
5,2012,10800,3868,14668,2,B6
6,2012,10774,3834,14608,2,B6
7,2012,10788,3756,14544,3,B6
8,2012,10721,3683,14404,3,B6
9,2012,10592,3715,14307,3,B6
10,2012,10617,3777,14394,4,B6
11,2012,10574,3781,14355,4,B6
12,2012,10573,3774,14347,4,B6
1,2013,10703,3779,14482,1,B6
2,2013,10786,3784,14570,1,B6
3,2013,10852,3845,14697,1,B6
4,2013,10972,3799,14771,2,B6
5,2013,11099,3819,14918,2,B6
6,2013,11123,3812,14935,2,B6
7,2013,11115,3766,14881,3,B6
8,2013,11128,3739,14867,3,B6
9,2013,11042,3826,14868,3,B6
10,2013,11059,3867,14926,4,B6
11,2013,11019,3942,14961,4,B6
12,2013,11021,3862,14883,4,B6
1,2014,11184,3870,15054,1,B6
2,2014,11361,3879,15240,1,B6
3,2014,11546,3933,15479,1,B6
4,2014,11669,3937,15606,2,B6
5,2014,11747,4020,15767,2,B6
6,2014,11408,4030,15438,2,B6
7,2014,11502,4021,15523,3,B6
8,2014,11465,3981,15446,3,B6
9,2014,11392,3977,15369,3,B6
10,2014,11581,4033,15614,4,B6
11,2014,11646,4061,15707,4,B6
12,2014,11642,4046,15688,4,B6
1,2015,11690,4122,15812,1,B6
2,2015,11829,4144,15973,1,B6
3,2015,11852,4255,16107,1,B6
4,2015,12106,4481,16587,2,B6
5,2015,12308,4567,16875,2,B6
6,2015,12435,4566,17001,2,B6
7,2015,12510,4588,17098,3,B6
8,2015,12555,4633,17188,3,B6
9,2015,12587,4580,17167,3,B6
10,2015,12679,4669,17348,4,B6
11,2015,12833,4761,17594,4,B6
12,2015,12833,4771,17604,4,B6
1,2016,12861,4787,17648,1,B6
2,2016,12987,4791,17778,1,B6
3,2016,13104,4706,17810,1,B6
4,2016,13221,4815,18036,2,B6
5,2016,13328,4817,18145,2,B6
6,2016,13530,4838,18368,2,B6
7,2016,13705,4848,18553,3,B6
8,2016,13842,4849,18691,3,B6
9,2016,13903,4841,18744,3,B6
10,2016,14032,4925,18957,4,B6
11,2016,14191,4980,19171,4,B6
12,2016,14090,4881,18971,4,B6
1,2017,14314,4950,19264,1,B6
2,2017,14363,4977,19340,1,B6
3,2017,14498,5017,19515,1,B6
4,2017,14705,5037,19742,2,B6
5,2017,14900,5129,20029,2,B6
6,2017,15051,5097,20148,2,B6
7,2017,15089,5100,20189,3,B6
8,2017,15017,5196,20213,3,B6
9,2017,15019,5192,20211,3,B6
10,2017,15158,5214,20372,4,B6
11,2017,15182,5212,20394,4,B6
12,2017,15139,5178,20317,4,B6
1,2018,15198,5249,20447,1,B6
2,2018,15363,5231,20594,1,B6
3,2018,15435,5171,20606,1,B6
4,2018,15582,5201,20783,2,B6
5,2018,15711,5234,20945,2,B6
6,2018,15716,5255,20971,2,B6
7,2018,15743,5285,21028,3,B6
8,2018,15741,5242,20983,3,B6
9,2018,15817,5294,21111,3,B6
10,2018,15855,5326,21181,4,B6
11,2018,15789,5289,21078,4,B6
12,2018,15767,5212,20979,4,B6
1,2019,15995,5211,21206,1,B6
2,2019,16079,5254,21333,1,B6
3,2019,16280,5204,21484,1,B6
4,2019,16398,5206,21604,2,B6
5,2019,16498,5148,21646,2,B6
6,2019,16642,5099,21741,2,B6
7,2019,16591,5080,21671,3,B6
8,2019,16602,5032,21634,3,B6
9,2019,16674,4972,21646,3,B6
10,2019,16751,4930,21681,4,B6
11,2019,16780,4906,21686,4,B6
12,2019,16648,4851,21499,4,B6
1,2020,16738,4860,21598,1,B6
2,2020,16856,4865,21721,1,B6
3,2020,16745,4801,21546,1,B6
4,2020,16756,4778,21534,2,B6
5,2020,16470,5155,21625,2,B6
6,2020,16418,5138,21556,2,B6
7,2020,16389,5028,21417,3,B6
8,2020,16246,4661,20907,3,B6
9,2020,15735,3913,19648,3,B6
10,2020,15539,3709,19248,4,B6
11,2020,15464,3650,19114,4,B6
12,2020,15377,3605,18982,4,B6
1,2021,15377,3641,19018,1,B6
2,2021,15296,3670,18966,1,B6
3,2021,15267,3678,18945,1,B6
4,2021,15127,3724,18851,2,B6
5,2021,15135,3674,18809,2,B6
6,2021,15088,3905,18993,2,B6
7,2021,15135,4074,19209,3,B6
8,2021,15154,4174,19328,3,B6
9,2021,15490,4368,19858,3,B6
10,2021,15947,4427,20374,4,B6
11,2021,16109,4440,20549,4,B6
12,2021,16293,4387,20680,4,B6
1,2022,16674,4467,21141,1,B6
2,2022,17062,4401,21463,1,B6
3,2022,17604,4363,21967,1,B6
4,2022,17936,4331,22267,2,B6
5,2022,18288,4450,22738,2,B6
6,2022,18303,4539,22842,2,B6
7,2022,18409,4561,22970,3,B6
8,2022,18333,4545,22878,3,B6
9,2022,18558,4506,23064,3,B6
10,2022,18786,4486,23272,4,B6
11,2022,18797,4448,23245,4,B6
12,2022,18661,4319,22980,4,B6
1,2023,18674,4282,22956,1,B6
2,2023,18938,4248,23186,1,B6
3,2023,19177,4197,23374,1,B6
4,2023,19322,4211,23533,2,B6
5,2023,19454,4143,23597,2,B6
6,2023,19272,4331,23603,2,B6
7,2023,19334,4180,23514,3,B6
8,2023,19077,4365,23442,3,B6
9,2023,19123,4344,23467,3,B6
10,2023,19551,3882,23433,4,B6
11,2023,19487,3872,23359,4,B6
12,2023,19372,3819,23191,4,B6
1,2024,19509,3808,23317,1,B6
2,2024,19337,3531,22868,1,B6
3,2024,19334,3473,22807,1,B6
4,2024,19511,3457,22968,2,B6
5,2024,19506,3466,22972,2,B6
6,2024,19467,3479,22946,2,B6
7,2024,19384,3450,22834,3,B6
8,2024,19384,3312,22696,3,B6
9,2024,19288,3292,22580,3,B6
10,2024,19386,3169,22555,4,B6
11,2024,19386,3169,22555,4,B6
12,2024,19338,3102,22440,4,B6
1,1990,2416,477,2893,1,HA
2,1990,2476,469,2945,1,HA
3,1990,2557,573,3130,1,HA
4,1990,2468,460,2928,2,HA
5,1990,2467,463,2930,2,HA
6,1990,2473,445,2918,2,HA
7,1990,2483,474,2957,3,HA
8,1990,2436,461,2897,3,HA
9,1990,2365,379,2744,3,HA
10,1990,2331,362,2693,4,HA
11,1990,2323,351,2674,4,HA
12,1990,2294,346,2640,4,HA
1,1991,2270,353,2623,1,HA
2,1991,2260,356,2616,1,HA
3,1991,2260,355,2615,1,HA
4,1991,2269,396,2665,2,HA
5,1991,2291,403,2694,2,HA
6,1991,2308,403,2711,2,HA
7,1991,2332,390,2722,3,HA
8,1991,2334,390,2724,3,HA
9,1991,2328,379,2707,3,HA
10,1991,2314,372,2686,4,HA
11,1991,2315,378,2693,4,HA
12,1991,2322,380,2702,4,HA
1,1992,2322,386,2708,1,HA
2,1992,2328,415,2743,1,HA
3,1992,2328,415,2743,1,HA
4,1992,2394,429,2823,2,HA
5,1992,2425,447,2872,2,HA
6,1992,2465,460,2925,2,HA
7,1992,2507,475,2982,3,HA
8,1992,2520,452,2972,3,HA
9,1992,2525,411,2936,3,HA
10,1992,2519,407,2926,4,HA
11,1992,2524,389,2913,4,HA
12,1992,2502,389,2891,4,HA
1,1993,2413,369,2782,1,HA
2,1993,2253,352,2605,1,HA
3,1993,2239,348,2587,1,HA
4,1993,2239,346,2585,2,HA
5,1993,2233,348,2581,2,HA
6,1993,2261,394,2655,2,HA
7,1993,2275,336,2611,3,HA
8,1993,2245,345,2590,3,HA
9,1993,2028,344,2372,3,HA
10,1993,1985,349,2334,4,HA
11,1993,1955,359,2314,4,HA
12,1993,1943,351,2294,4,HA
1,1994,1946,342,2288,1,HA
2,1994,2128,339,2467,1,HA
3,1994,2119,342,2461,1,HA
4,1994,2121,353,2474,2,HA
5,1994,2139,393,2532,2,HA
6,1994,2162,399,2561,2,HA
7,1994,2178,383,2561,3,HA
8,1994,2158,407,2565,3,HA
9,1994,2131,374,2505,3,HA
10,1994,2093,377,2470,4,HA
11,1994,2085,369,2454,4,HA
12,1994,2097,360,2457,4,HA
1,1995,2105,355,2460,1,HA
2,1995,2106,349,2455,1,HA
3,1995,2089,346,2435,1,HA
4,1995,2056,345,2401,2,HA
5,1995,2095,359,2454,2,HA
6,1995,2093,374,2467,2,HA
7,1995,2095,368,2463,3,HA
8,1995,2094,359,2453,3,HA
9,1995,2073,337,2410,3,HA
10,1995,2076,337,2413,4,HA
11,1995,2065,350,2415,4,HA
12,1995,2053,247,2300,4,HA
1,1996,2051,347,2398,1,HA
2,1996,2048,345,2393,1,HA
3,1996,2049,352,2401,1,HA
4,1996,2049,365,2414,2,HA
5,1996,2073,389,2462,2,HA
6,1996,2072,407,2479,2,HA
7,1996,2084,388,2472,3,HA
8,1996,2078,384,2462,3,HA
9,1996,2076,371,2447,3,HA
10,1996,2084,369,2453,4,HA
11,1996,2096,365,2461,4,HA
12,1996,2163,360,2523,4,HA
1,1997,2162,354,2516,1,HA
2,1997,2163,353,2516,1,HA
3,1997,2169,346,2515,1,HA
4,1997,2162,352,2514,2,HA
5,1997,2165,378,2543,2,HA
6,1997,2171,397,2568,2,HA
7,1997,2169,410,2579,3,HA
8,1997,2169,401,2570,3,HA
9,1997,2168,405,2573,3,HA
10,1997,2168,391,2559,4,HA
11,1997,2165,389,2554,4,HA
12,1997,2172,379,2551,4,HA
1,1998,2170,389,2559,1,HA
2,1998,2167,388,2555,1,HA
3,1998,2170,405,2575,1,HA
4,1998,2164,400,2564,2,HA
5,1998,2196,426,2622,2,HA
6,1998,2204,451,2655,2,HA
7,1998,2215,491,2706,3,HA
8,1998,2220,482,2702,3,HA
9,1998,2238,437,2675,3,HA
10,1998,2240,456,2696,4,HA
11,1998,2239,448,2687,4,HA
12,1998,2245,452,2697,4,HA
1,1999,2256,444,2700,1,HA
2,1999,2327,421,2748,1,HA
3,1999,2412,437,2849,1,HA
4,1999,2440,467,2907,2,HA
5,1999,2484,572,3056,2,HA
6,1999,2534,618,3152,2,HA
7,1999,2551,616,3167,3,HA
8,1999,2577,613,3190,3,HA
9,1999,2603,549,3152,3,HA
10,1999,2612,543,3155,4,HA
11,1999,2655,547,3202,4,HA
12,1999,2569,522,3091,4,HA
1,2000,2702,530,3232,1,HA
2,2000,2754,517,3271,1,HA
3,2000,2780,535,3315,1,HA
4,2000,2795,543,3338,2,HA
5,2000,2842,594,3436,2,HA
6,2000,2879,591,3470,2,HA
7,2000,2890,605,3495,3,HA
8,2000,2889,598,3487,3,HA
9,2000,2887,559,3446,3,HA
10,2000,2871,547,3418,4,HA
11,2000,2849,560,3409,4,HA
12,2000,2874,561,3435,4,HA
1,2001,2876,561,3437,1,HA
2,2001,2878,544,3422,1,HA
3,2001,2874,548,3422,1,HA
4,2001,2902,561,3463,2,HA
5,2001,2931,586,3517,2,HA
6,2001,2943,595,3538,2,HA
7,2001,2947,592,3539,3,HA
8,2001,2960,580,3540,3,HA
9,2001,2659,481,3140,3,HA
10,2001,2596,497,3093,4,HA
11,2001,2573,503,3076,4,HA
12,2001,2572,497,3069,4,HA
1,2002,2583,492,3075,1,HA
2,2002,2581,503,3084,1,HA
3,2002,2573,485,3058,1,HA
4,2002,2570,496,3066,2,HA
5,2002,2706,478,3184,2,HA
6,2002,2785,536,3321,2,HA
7,2002,2793,581,3374,3,HA
8,2002,2777,605,3382,3,HA
9,2002,2775,621,3396,3,HA
10,2002,2778,589,3367,4,HA
11,2002,2754,573,3327,4,HA
12,2002,2719,504,3223,4,HA
1,2003,2801,510,3311,1,HA
2,2003,2773,512,3285,1,HA
3,2003,2684,536,3220,1,HA
4,2003,2665,548,3213,2,HA
5,2003,2618,640,3258,2,HA
6,2003,2642,634,3276,2,HA
7,2003,2654,639,3293,3,HA
8,2003,2637,673,3310,3,HA
9,2003,2590,654,3244,3,HA
10,2003,2592,660,3252,4,HA
11,2003,2634,668,3302,4,HA
12,2003,2625,685,3310,4,HA
1,2004,2631,646,3277,1,HA
2,2004,2649,642,3291,1,HA
3,2004,2619,679,3298,1,HA
4,2004,2635,668,3303,2,HA
5,2004,2663,693,3356,2,HA
6,2004,2712,677,3389,2,HA
7,2004,2702,699,3401,3,HA
8,2004,2687,688,3375,3,HA
9,2004,2673,671,3344,3,HA
10,2004,2664,676,3340,4,HA
11,2004,2710,675,3385,4,HA
12,2004,3685,686,4371,4,HA
1,2005,2673,671,3344,1,HA
2,2005,2675,684,3359,1,HA
3,2005,2670,669,3339,1,HA
4,2005,2677,674,3351,2,HA
5,2005,2679,655,3334,2,HA
6,2005,2698,658,3356,2,HA
7,2005,2711,659,3370,3,HA
8,2005,2711,694,3405,3,HA
9,2005,2700,719,3419,3,HA
10,2005,2709,760,3469,4,HA
11,2005,2711,750,3461,4,HA
12,2005,2689,765,3454,4,HA
1,2006,2663,753,3416,1,HA
2,2006,2641,765,3406,1,HA
3,2006,2663,758,3421,1,HA
4,2006,2674,767,3441,2,HA
5,2006,2679,778,3457,2,HA
6,2006,2671,779,3450,2,HA
7,2006,2667,760,3427,3,HA
8,2006,2689,762,3451,3,HA
9,2006,2714,783,3497,3,HA
10,2006,2611,759,3370,4,HA
11,2006,2719,782,3501,4,HA
12,2006,2742,832,3574,4,HA
1,2007,2774,811,3585,1,HA
2,2007,2778,815,3593,1,HA
3,2007,2773,837,3610,1,HA
4,2007,2772,826,3598,2,HA
5,2007,2727,805,3532,2,HA
6,2007,2675,806,3481,2,HA
7,2007,2678,802,3480,3,HA
8,2007,2669,792,3461,3,HA
9,2007,2663,775,3438,3,HA
10,2007,2640,791,3431,4,HA
11,2007,2640,791,3431,4,HA
12,2007,2650,795,3445,4,HA
1,2008,2649,761,3410,1,HA
2,2008,2674,763,3437,1,HA
3,2008,2695,805,3500,1,HA
4,2008,2695,763,3458,2,HA
5,2008,2723,868,3591,2,HA
6,2008,2774,900,3674,2,HA
7,2008,2821,894,3715,3,HA
8,2008,2808,894,3702,3,HA
9,2008,2816,876,3692,3,HA
10,2008,2911,883,3794,4,HA
11,2008,2818,866,3684,4,HA
12,2008,2817,890,3707,4,HA
1,2009,2821,883,3704,1,HA
2,2009,2828,875,3703,1,HA
3,2009,2836,881,3717,1,HA
4,2009,2901,888,3789,2,HA
5,2009,2924,812,3736,2,HA
6,2009,2946,809,3755,2,HA
7,2009,2955,825,3780,3,HA
8,2009,2946,813,3759,3,HA
9,2009,2960,820,3780,3,HA
10,2009,2960,830,3790,4,HA
11,2009,2982,839,3821,4,HA
12,2009,2988,856,3844,4,HA
1,2010,2994,863,3857,1,HA
2,2010,2994,860,3854,1,HA
3,2010,2997,879,3876,1,HA
4,2010,2990,880,3870,2,HA
5,2010,2999,904,3903,2,HA
6,2010,3032,908,3940,2,HA
7,2010,3039,913,3952,3,HA
8,2010,3058,909,3967,3,HA
9,2010,3055,903,3958,3,HA
10,2010,3064,921,3985,4,HA
11,2010,3089,932,4021,4,HA
12,2010,3094,929,4023,4,HA
1,2011,3070,930,4000,1,HA
2,2011,3066,933,3999,1,HA
3,2011,3084,940,4024,1,HA
4,2011,3136,920,4056,2,HA
5,2011,3176,914,4090,2,HA
6,2011,3240,906,4146,2,HA
7,2011,3240,906,4146,3,HA
8,2011,3256,919,4175,3,HA
9,2011,3273,949,4222,3,HA
10,2011,3278,949,4227,4,HA
11,2011,3309,946,4255,4,HA
12,2011,3350,964,4314,4,HA
1,2012,3357,964,4321,1,HA
2,2012,3476,962,4438,1,HA
3,2012,3496,955,4451,1,HA
4,2012,3578,942,4520,2,HA
5,2012,3649,953,4602,2,HA
6,2012,3653,971,4624,2,HA
7,2012,3684,962,4646,3,HA
8,2012,3757,973,4730,3,HA
9,2012,3783,973,4756,3,HA
10,2012,3815,1002,4817,4,HA
11,2012,3832,1039,4871,4,HA
12,2012,3866,1040,4906,4,HA
1,2013,3877,1032,4909,1,HA
2,2013,3940,1025,4965,1,HA
3,2013,3939,1023,4962,1,HA
4,2013,4045,1013,5058,2,HA
5,2013,4117,1002,5119,2,HA
6,2013,4154,1003,5157,2,HA
7,2013,4181,1002,5183,3,HA
8,2013,4204,1011,5215,3,HA
9,2013,4213,1020,5233,3,HA
10,2013,4231,1018,5249,4,HA
11,2013,4234,1020,5254,4,HA
12,2013,4237,1012,5249,4,HA
1,2014,4252,1043,5295,1,HA
2,2014,4258,1053,5311,1,HA
3,2014,4269,1070,5339,1,HA
4,2014,4264,1081,5345,2,HA
5,2014,4265,1098,5363,2,HA
6,2014,4262,1100,5362,2,HA
7,2014,4252,1097,5349,3,HA
8,2014,4259,1087,5346,3,HA
9,2014,4259,1072,5331,3,HA
10,2014,4263,1075,5338,4,HA
11,2014,4304,1080,5384,4,HA
12,2014,4311,1069,5380,4,HA
1,2015,4314,1071,5385,1,HA
2,2015,4318,1063,5381,1,HA
3,2015,4322,1049,5371,1,HA
4,2015,4344,1035,5379,2,HA
5,2015,4395,1044,5439,2,HA
6,2015,4400,1039,5439,2,HA
7,2015,4421,1033,5454,3,HA
8,2015,4436,1029,5465,3,HA
9,2015,4444,1031,5475,3,HA
10,2015,4460,1037,5497,4,HA
11,2015,4477,1041,5518,4,HA
12,2015,4499,1049,5548,4,HA
1,2016,4538,1062,5600,1,HA
2,2016,4598,1071,5669,1,HA
3,2016,4628,1093,5721,1,HA
4,2016,4665,1118,5783,2,HA
5,2016,4736,1155,5891,2,HA
6,2016,4760,1185,5945,2,HA
7,2016,4796,1195,5991,3,HA
8,2016,4840,1219,6059,3,HA
9,2016,4859,1215,6074,3,HA
10,2016,4892,1217,6109,4,HA
11,2016,4948,1243,6191,4,HA
12,2016,4952,1247,6199,4,HA
1,2017,4978,1244,6222,1,HA
2,2017,4985,1233,6218,1,HA
3,2017,5005,1229,6234,1,HA
4,2017,5008,1256,6264,2,HA
5,2017,5040,1298,6338,2,HA
6,2017,5053,1303,6356,2,HA
7,2017,5084,1307,6391,3,HA
8,2017,5147,1315,6462,3,HA
9,2017,5162,1329,6491,3,HA
10,2017,5223,1383,6606,4,HA
11,2017,5261,1399,6660,4,HA
12,2017,5296,1446,6742,4,HA
1,2018,5370,1439,6809,1,HA
2,2018,5464,1432,6896,1,HA
3,2018,5486,1423,6909,1,HA
4,2018,5572,1432,7004,2,HA
5,2018,5680,1438,7118,2,HA
6,2018,5686,1456,7142,2,HA
7,2018,5712,1447,7159,3,HA
8,2018,5692,1453,7145,3,HA
9,2018,5698,1454,7152,3,HA
10,2018,5723,1464,7187,4,HA
11,2018,5733,1488,7221,4,HA
12,2018,5728,1516,7244,4,HA
1,2019,5743,1507,7250,1,HA
2,2019,5772,1500,7272,1,HA
3,2019,5812,1487,7299,1,HA
4,2019,5823,1471,7294,2,HA
5,2019,5843,1469,7312,2,HA
6,2019,5895,1465,7360,2,HA
7,2019,5913,1443,7356,3,HA
8,2019,5906,1443,7349,3,HA
9,2019,5925,1464,7389,3,HA
10,2019,5945,1466,7411,4,HA
11,2019,5992,1461,7453,4,HA
12,2019,6011,1426,7437,4,HA
1,2020,6024,1423,7447,1,HA
2,2020,6067,1435,7502,1,HA
3,2020,6076,1416,7492,1,HA
4,2020,6065,1411,7476,2,HA
5,2020,6057,1387,7444,2,HA
6,2020,6039,1379,7418,2,HA
7,2020,6028,1376,7404,3,HA
8,2020,5923,1369,7292,3,HA
9,2020,5846,1241,7087,3,HA
10,2020,5231,1289,6520,4,HA
11,2020,4513,530,5043,4,HA
12,2020,4572,706,5278,4,HA
1,2021,4793,691,5484,1,HA
2,2021,5329,685,6014,1,HA
3,2021,5351,698,6049,1,HA
4,2021,4883,846,5729,2,HA
5,2021,5064,899,5963,2,HA
6,2021,5104,929,6033,2,HA
7,2021,5121,957,6078,3,HA
8,2021,5141,965,6106,3,HA
9,2021,5493,962,6455,3,HA
10,2021,5536,987,6523,4,HA
11,2021,5556,1012,6568,4,HA
12,2021,5585,1014,6599,4,HA
1,2022,5549,999,6548,1,HA
2,2022,5508,1007,6515,1,HA
3,2022,5569,1017,6586,1,HA
4,2022,5705,997,6702,2,HA
5,2022,5811,998,6809,2,HA
6,2022,5912,1016,6928,2,HA
7,2022,5990,1023,7013,3,HA
8,2022,6001,1034,7035,3,HA
9,2022,6108,1002,7110,3,HA
10,2022,6156,1002,7158,4,HA
11,2022,6195,880,7075,4,HA
12,2022,6235,872,7107,4,HA
1,2023,6273,909,7182,1,HA
2,2023,6317,903,7220,1,HA
3,2023,6332,886,7218,1,HA
4,2023,6369,866,7235,2,HA
5,2023,6389,878,7267,2,HA
6,2023,6448,861,7309,2,HA
7,2023,6479,866,7345,3,HA
8,2023,6490,880,7370,3,HA
9,2023,6494,853,7347,3,HA
10,2023,6510,862,7372,4,HA
11,2023,6535,860,7395,4,HA
12,2023,6522,840,7362,4,HA
1,2024,6520,845,7365,1,HA
2,2024,6536,838,7374,1,HA
3,2024,6535,851,7386,1,HA
4,2024,6545,835,7380,2,HA
5,2024,6546,846,7392,2,HA
6,2024,6582,834,7416,2,HA
7,2024,6597,840,7437,3,HA
8,2024,6595,825,7420,3,HA
9,2024,6588,822,7410,3,HA
10,2024,6573,823,7396,4,HA
11,2024,6560,828,7388,4,HA
12,2024,6541,821,7362,4,HA
7,1994,225,0,225,3,F9
8,1994,279,0,279,3,F9
9,1994,309,0,309,3,F9
10,1994,324,0,324,4,F9
11,1994,331,0,331,4,F9
12,1994,327,0,327,4,F9
1,1995,320,0,320,1,F9
2,1995,326,20,346,1,F9
3,1995,318,20,338,1,F9
4,1995,318,20,338,2,F9
5,1995,279,75,354,2,F9
6,1995,293,96,389,2,F9
7,1995,330,72,402,3,F9
8,1995,355,70,425,3,F9
9,1995,317,71,388,3,F9
10,1995,338,43,381,4,F9
11,1995,393,39,432,4,F9
12,1995,405,42,447,4,F9
1,1996,407,43,450,1,F9
2,1996,421,43,464,1,F9
3,1996,456,77,533,1,F9
4,1996,504,79,583,2,F9
5,1996,526,83,609,2,F9
6,1996,543,78,621,2,F9
7,1996,568,90,658,3,F9
8,1996,606,105,711,3,F9
9,1996,620,106,726,3,F9
10,1996,613,105,718,4,F9
11,1996,608,104,712,4,F9
12,1996,606,108,714,4,F9
1,1997,609,102,711,1,F9
2,1997,615,98,713,1,F9
3,1997,630,108,738,1,F9
4,1997,661,108,769,2,F9
5,1997,694,104,798,2,F9
6,1997,694,104,798,2,F9
7,1997,694,122,816,3,F9
8,1997,744,125,869,3,F9
9,1997,744,125,869,3,F9
10,1997,756,132,888,4,F9
11,1997,756,132,888,4,F9
12,1997,752,146,898,4,F9
1,1998,740,149,889,1,F9
2,1998,758,153,911,1,F9
3,1998,760,166,926,1,F9
4,1998,745,162,907,2,F9
5,1998,750,175,925,2,F9
6,1998,754,197,951,2,F9
7,1998,754,197,951,3,F9
8,1998,803,234,1037,3,F9
9,1998,857,267,1124,3,F9
10,1998,898,304,1202,4,F9
11,1998,957,304,1261,4,F9
12,1998,941,295,1236,4,F9
1,1999,960,299,1259,1,F9
2,1999,1036,307,1343,1,F9
3,1999,1179,323,1502,1,F9
4,1999,1226,334,1560,2,F9
5,1999,1260,347,1607,2,F9
6,1999,1263,375,1638,2,F9
7,1999,1354,390,1744,3,F9
8,1999,1379,394,1773,3,F9
9,1999,1372,391,1763,3,F9
10,1999,1384,421,1805,4,F9
11,1999,1462,430,1892,4,F9
12,1999,1515,433,1948,4,F9
1,2000,1545,448,1993,1,F9
2,2000,1653,401,2054,1,F9
3,2000,1659,408,2067,1,F9
4,2000,1847,486,2333,2,F9
5,2000,1642,490,2132,2,F9
6,2000,1696,434,2130,2,F9
7,2000,1717,464,2181,3,F9
8,2000,1781,471,2252,3,F9
9,2000,1794,479,2273,3,F9
10,2000,1836,487,2323,4,F9
11,2000,1841,477,2318,4,F9
12,2000,1847,470,2317,4,F9
1,2001,1534,477,2011,1,F9
2,2001,1960,460,2420,1,F9
3,2001,1993,448,2441,1,F9
4,2001,1654,455,2109,2,F9
5,2001,2089,404,2493,2,F9
6,2001,2071,437,2508,2,F9
7,2001,2109,446,2555,3,F9
8,2001,2126,443,2569,3,F9
9,2001,2054,455,2509,3,F9
10,2001,1942,459,2401,4,F9
11,2001,1945,482,2427,4,F9
12,2001,1954,487,2441,4,F9
1,2002,2015,544,2559,1,F9
2,2002,2010,519,2529,1,F9
3,2002,2142,557,2699,1,F9
4,2002,2203,591,2794,2,F9
5,2002,2263,590,2853,2,F9
6,2002,2364,595,2959,2,F9
7,2002,2362,598,2960,3,F9
8,2002,2354,613,2967,3,F9
9,2002,2337,599,2936,3,F9
10,2002,2422,595,3017,4,F9
11,2002,2438,594,3032,4,F9
12,2002,3020,600,3620,4,F9
1,2003,2436,614,3050,1,F9
2,2003,2477,637,3114,1,F9
3,2003,2516,641,3157,1,F9
4,2003,2535,674,3209,2,F9
5,2003,2647,725,3372,2,F9
6,2003,2663,730,3393,2,F9
7,2003,2616,738,3354,3,F9
8,2003,2710,748,3458,3,F9
9,2003,2775,796,3571,3,F9
10,2003,2880,792,3672,4,F9
11,2003,2947,812,3759,4,F9
12,2003,2961,807,3768,4,F9
1,2004,3067,801,3868,1,F9
2,2004,3198,0,3198,1,F9
3,2004,3331,855,4186,1,F9
4,2004,3414,882,4296,2,F9
5,2004,3453,906,4359,2,F9
6,2004,3490,895,4385,2,F9
7,2004,3522,894,4416,3,F9
8,2004,3576,886,4462,3,F9
9,2004,3627,882,4509,3,F9
10,2004,3629,901,4530,4,F9
11,2004,3629,885,4514,4,F9
12,2004,3620,872,4492,4,F9
1,2005,3648,885,4533,1,F9
2,2005,3639,876,4515,1,F9
3,2005,3630,868,4498,1,F9
4,2005,3631,883,4514,2,F9
5,2005,3611,910,4521,2,F9
6,2005,3591,923,4514,2,F9
7,2005,3641,951,4592,3,F9
8,2005,3612,940,4552,3,F9
9,2005,3624,945,4569,3,F9
10,2005,3645,932,4577,4,F9
11,2005,3635,930,4565,4,F9
12,2005,3635,915,4550,4,F9
1,2006,3720,918,4638,1,F9
2,2006,3789,935,4724,1,F9
3,2006,3833,916,4749,1,F9
4,2006,3841,914,4755,2,F9
5,2006,3971,903,4874,2,F9
6,2006,4012,943,4955,2,F9
7,2006,4044,970,5014,3,F9
8,2006,4056,965,5021,3,F9
9,2006,4042,951,4993,3,F9
10,2006,4038,949,4987,4,F9
11,2006,4060,949,5009,4,F9
12,2006,4052,939,4991,4,F9
1,2007,4078,934,5012,1,F9
2,2007,4149,929,5078,1,F9
3,2007,4225,931,5156,1,F9
4,2007,4334,931,5265,2,F9
5,2007,4403,959,5362,2,F9
6,2007,4457,965,5422,2,F9
7,2007,4564,1024,5588,3,F9
8,2007,4605,1058,5663,3,F9
9,2007,4663,1086,5749,3,F9
10,2007,4648,1091,5739,4,F9
11,2007,4712,1070,5782,4,F9
12,2007,4694,1043,5737,4,F9
1,2008,4738,1071,5809,1,F9
2,2008,4717,1075,5792,1,F9
3,2008,4619,1052,5671,1,F9
4,2008,4569,1042,5611,2,F9
5,2008,4569,1048,5617,2,F9
6,2008,4439,1020,5459,2,F9
7,2008,4235,1013,5248,3,F9
8,2008,4098,957,5055,3,F9
9,2008,3953,1052,5005,3,F9
10,2008,3945,1030,4975,4,F9
11,2008,3914,1056,4970,4,F9
12,2008,3943,907,4850,4,F9
1,2009,3915,998,4913,1,F9
2,2009,3913,984,4897,1,F9
3,2009,3887,998,4885,1,F9
4,2009,3918,990,4908,2,F9
5,2009,3929,990,4919,2,F9
6,2009,3901,979,4880,2,F9
7,2009,3876,965,4841,3,F9
8,2009,3849,976,4825,3,F9
9,2009,3784,985,4769,3,F9
10,2009,3793,981,4774,4,F9
11,2009,3856,992,4848,4,F9
12,2009,4342,1380,5722,4,F9
1,2010,4429,1369,5798,1,F9
2,2010,4370,1381,5751,1,F9
3,2010,4257,1417,5674,1,F9
4,2010,4245,1349,5594,2,F9
5,2010,4299,1154,5453,2,F9
6,2010,4267,1132,5399,2,F9
7,2010,4268,1113,5381,3,F9
8,2010,4292,1109,5401,3,F9
9,2010,4311,1329,5640,3,F9
10,2010,4174,1330,5504,4,F9
11,2010,4303,1337,5640,4,F9
12,2010,4237,1319,5556,4,F9
1,2011,4233,1331,5564,1,F9
2,2011,4243,1321,5564,1,F9
3,2011,4247,1310,5557,1,F9
4,2011,4268,1321,5589,2,F9
5,2011,4292,1303,5595,2,F9
6,2011,4312,1307,5619,2,F9
7,2011,4299,1278,5577,3,F9
8,2011,4360,1267,5627,3,F9
9,2011,4286,1253,5539,3,F9
10,2011,4226,1218,5444,4,F9
11,2011,4071,1173,5244,4,F9
12,2011,4071,1173,5244,4,F9
1,2012,3960,1150,5110,1,F9
2,2012,3942,1131,5073,1,F9
3,2012,3877,1098,4975,1,F9
4,2012,3796,1069,4865,2,F9
5,2012,3724,1039,4763,2,F9
6,2012,3678,1028,4706,2,F9
7,2012,3621,1009,4630,3,F9
8,2012,3535,1042,4577,3,F9
9,2012,3517,1053,4570,3,F9
10,2012,3474,1066,4540,4,F9
11,2012,3418,1064,4482,4,F9
12,2012,3374,1048,4422,4,F9
1,2013,3343,1045,4388,1,F9
2,2013,3327,1046,4373,1,F9
3,2013,3302,1011,4313,1,F9
4,2013,3254,965,4219,2,F9
5,2013,3255,938,4193,2,F9
6,2013,3169,882,4051,2,F9
7,2013,3170,883,4053,3,F9
8,2013,3137,825,3962,3,F9
9,2013,3094,763,3857,3,F9
10,2013,3077,719,3796,4,F9
11,2013,3099,690,3789,4,F9
12,2013,3159,669,3828,4,F9
1,2014,3079,666,3745,1,F9
2,2014,3233,663,3896,1,F9
3,2014,3173,661,3834,1,F9
4,2014,3295,666,3961,2,F9
5,2014,3332,676,4008,2,F9
6,2014,3342,686,4028,2,F9
7,2014,3397,702,4099,3,F9
8,2014,3487,689,4176,3,F9
9,2014,3412,691,4103,3,F9
10,2014,3374,658,4032,4,F9
11,2014,3352,639,3991,4,F9
12,2014,3320,609,3929,4,F9
1,2015,3338,547,3885,1,F9
2,2015,3312,525,3837,1,F9
3,2015,2913,218,3131,1,F9
4,2015,2872,78,2950,2,F9
5,2015,2709,45,2754,2,F9
6,2015,2735,40,2775,2,F9
7,2015,2767,39,2806,3,F9
8,2015,2756,39,2795,3,F9
9,2015,2846,45,2891,3,F9
10,2015,2883,43,2926,4,F9
11,2015,2853,44,2897,4,F9
12,2015,2929,47,2976,4,F9
1,2016,2939,46,2985,1,F9
2,2016,2980,43,3023,1,F9
3,2016,2995,40,3035,1,F9
4,2016,3051,37,3088,2,F9
5,2016,3038,37,3075,2,F9
6,2016,3120,38,3158,2,F9
7,2016,3126,41,3167,3,F9
8,2016,3161,40,3201,3,F9
9,2016,3241,41,3282,3,F9
10,2016,3288,41,3329,4,F9
11,2016,3359,41,3400,4,F9
12,2016,3372,40,3412,4,F9
1,2017,3394,39,3433,1,F9
2,2017,3453,38,3491,1,F9
3,2017,3516,35,3551,1,F9
4,2017,3573,34,3607,2,F9
5,2017,3590,34,3624,2,F9
6,2017,3600,36,3636,2,F9
7,2017,3558,35,3593,3,F9
8,2017,3607,32,3639,3,F9
9,2017,3566,34,3600,3,F9
10,2017,3597,39,3636,4,F9
11,2017,3650,40,3690,4,F9
12,2017,3682,39,3721,4,F9
1,2018,3706,39,3745,1,F9
2,2018,3713,38,3751,1,F9
3,2018,3763,37,3800,1,F9
4,2018,3826,37,3863,2,F9
5,2018,3880,41,3921,2,F9
6,2018,3950,41,3991,2,F9
7,2018,3991,39,4030,3,F9
8,2018,4028,36,4064,3,F9
9,2018,4068,36,4104,3,F9
10,2018,4160,39,4199,4,F9
11,2018,4225,39,4264,4,F9
12,2018,4197,37,4234,4,F9
1,2019,4309,34,4343,1,F9
2,2019,4372,40,4412,1,F9
3,2019,4405,42,4447,1,F9
4,2019,4458,39,4497,2,F9
5,2019,4581,48,4629,2,F9
6,2019,4639,51,4690,2,F9
7,2019,4669,51,4720,3,F9
8,2019,4702,47,4749,3,F9
9,2019,4787,48,4835,3,F9
10,2019,4834,46,4880,4,F9
11,2019,4893,45,4938,4,F9
12,2019,4905,60,4965,4,F9
1,2020,4957,63,5020,1,F9
2,2020,5036,65,5101,1,F9
3,2020,5115,66,5181,1,F9
4,2020,5090,63,5153,2,F9
5,2020,5076,63,5139,2,F9
6,2020,5040,61,5101,2,F9
7,2020,5028,68,5096,3,F9
8,2020,5015,65,5080,3,F9
9,2020,4990,65,5055,3,F9
10,2020,4955,64,5019,4,F9
11,2020,4957,64,5021,4,F9
12,2020,4948,63,5011,4,F9
1,2021,4934,62,4996,1,F9
2,2021,4891,61,4952,1,F9
3,2021,4898,48,4946,1,F9
4,2021,4948,47,4995,2,F9
5,2021,4984,47,5031,2,F9
6,2021,5129,49,5178,2,F9
7,2021,5210,50,5260,3,F9
8,2021,5302,48,5350,3,F9
9,2021,5381,48,5429,3,F9
10,2021,5441,46,5487,4,F9
11,2021,5496,43,5539,4,F9
12,2021,5459,43,5502,4,F9
1,2022,5485,44,5529,1,F9
2,2022,5520,44,5564,1,F9
3,2022,5525,40,5565,1,F9
4,2022,5590,39,5629,2,F9
5,2022,5658,39,5697,2,F9
6,2022,5694,35,5729,2,F9
7,2022,5775,36,5811,3,F9
8,2022,5976,37,6013,3,F9
9,2022,6106,39,6145,3,F9
10,2022,6275,40,6315,4,F9
11,2022,6376,39,6415,4,F9
12,2022,6429,41,6470,4,F9
1,2023,6455,41,6496,1,F9
2,2023,6503,43,6546,1,F9
3,2023,6566,42,6608,1,F9
4,2023,6529,43,6572,2,F9
5,2023,6610,41,6651,2,F9
6,2023,6669,46,6715,2,F9
7,2023,6790,39,6829,3,F9
8,2023,6830,42,6872,3,F9
9,2023,6939,40,6979,3,F9
10,2023,7023,43,7066,4,F9
11,2023,7070,43,7113,4,F9
12,2023,7193,42,7235,4,F9
1,2024,7256,41,7297,1,F9
2,2024,7481,41,7522,1,F9
3,2024,7655,40,7695,1,F9
4,2024,7817,40,7857,2,F9
5,2024,7948,40,7988,2,F9
6,2024,8072,56,8128,2,F9
7,2024,8116,55,8171,3,F9
8,2024,8037,55,8092,3,F9
9,2024,7984,53,8037,3,F9
10,2024,7888,52,7940,4,F9
11,2024,7893,50,7943,4,F9
12,2024,7888,50,7938,4,F9
1,1990,56340,4226,60566,1,DL
2,1990,56413,4184,60597,1,DL
3,1990,56700,4117,60817,1,DL
4,1990,56630,4112,60742,2,DL
5,1990,56932,4156,61088,2,DL
6,1990,57478,4197,61675,2,DL
7,1990,58200,4377,62577,3,DL
8,1990,58220,4433,62653,3,DL
9,1990,57844,4433,62277,3,DL
10,1990,58190,4433,62623,4,DL
11,1990,57989,4450,62439,4,DL
12,1990,58413,4500,62913,4,DL
1,1991,58446,4531,62977,1,DL
2,1991,58938,4608,63546,1,DL
3,1991,59285,4794,64079,1,DL
4,1991,59716,4980,64696,2,DL
5,1991,60649,5076,65725,2,DL
6,1991,61392,5120,66512,2,DL
7,1991,62147,5167,67314,3,DL
8,1991,62179,5216,67395,3,DL
9,1991,63178,4860,68038,3,DL
10,1991,63927,4882,68809,4,DL
11,1991,71204,4929,76133,4,DL
12,1991,71512,5249,76761,4,DL
1,1992,71914,5325,77239,1,DL
2,1992,71915,5365,77280,1,DL
3,1992,72080,5325,77405,1,DL
4,1992,71949,5337,77286,2,DL
5,1992,72508,5338,77846,2,DL
6,1992,72507,5339,77846,2,DL
7,1992,72909,5233,78142,3,DL
8,1992,72433,5066,77499,3,DL
9,1992,71429,4430,75859,3,DL
10,1992,71013,4328,75341,4,DL
11,1992,70338,4373,74711,4,DL
12,1992,69370,4337,73707,4,DL
1,1993,68359,4387,72746,1,DL
2,1993,68047,4350,72397,1,DL
3,1993,67983,4405,72388,1,DL
4,1993,67916,4573,72489,2,DL
5,1993,68227,4866,73093,2,DL
6,1993,68379,5154,73533,2,DL
7,1993,68294,5309,73603,3,DL
8,1993,68155,5395,73550,3,DL
9,1993,67425,5638,73063,3,DL
10,1993,66822,5741,72563,4,DL
11,1993,65233,5755,70988,4,DL
12,1993,65212,5916,71128,4,DL
1,1994,64963,5854,70817,1,DL
2,1994,65698,4966,70664,1,DL
3,1994,65735,5425,71160,1,DL
4,1994,67750,5610,73360,2,DL
5,1994,65823,5745,71568,2,DL
6,1994,65595,5817,71412,2,DL
7,1994,65870,5746,71616,3,DL
8,1994,65428,5102,70530,3,DL
9,1994,61267,5405,66672,3,DL
10,1994,61424,6006,67430,4,DL
11,1994,60162,6680,66842,4,DL
12,1994,59327,6965,66292,4,DL
1,1995,56789,7082,63871,1,DL
2,1995,56632,7230,63862,1,DL
3,1995,56321,7258,63579,1,DL
4,1995,56141,7272,63413,2,DL
5,1995,55692,7367,63059,2,DL
6,1995,55063,7769,62832,2,DL
7,1995,52860,9590,62450,3,DL
8,1995,52810,9629,62439,3,DL
9,1995,52214,9564,61778,3,DL
10,1995,52056,9582,61638,4,DL
11,1995,52604,8906,61510,4,DL
12,1995,52654,8991,61645,4,DL
1,1996,51917,8984,60901,1,DL
2,1996,52033,8974,61007,1,DL
3,1996,51982,9128,61110,1,DL
4,1996,52243,9528,61771,2,DL
5,1996,53499,9963,63462,2,DL
6,1996,53969,10094,64063,2,DL
7,1996,54374,10059,64433,3,DL
8,1996,54484,10271,64755,3,DL
9,1996,54910,11388,66298,3,DL
10,1996,55238,11595,66833,4,DL
11,1996,55366,11262,66628,4,DL
12,1996,55735,11701,67436,4,DL
1,1997,55768,11416,67184,1,DL
2,1997,55995,11309,67304,1,DL
3,1997,56335,11516,67851,1,DL
4,1997,56590,11495,68085,2,DL
5,1997,56603,11742,68345,2,DL
6,1997,56865,12253,69118,2,DL
7,1997,57093,12828,69921,3,DL
8,1997,57301,12459,69760,3,DL
9,1997,57254,12248,69502,3,DL
10,1997,58011,11969,69980,4,DL
11,1997,57843,11790,69633,4,DL
12,1997,58104,11878,69982,4,DL
1,1998,58987,11483,70470,1,DL
2,1998,59978,11042,71020,1,DL
3,1998,60943,11019,71962,1,DL
4,1998,61612,10858,72470,2,DL
5,1998,62237,11292,73529,2,DL
6,1998,62648,11468,74116,2,DL
7,1998,62870,11477,74347,3,DL
8,1998,63007,12626,75633,3,DL
9,1998,62906,12816,75722,3,DL
10,1998,63089,12772,75861,4,DL
11,1998,62999,13328,76327,4,DL
12,1998,63569,13080,76649,4,DL
1,1999,63263,13619,76882,1,DL
2,1999,63425,13503,76928,1,DL
3,1999,63648,13681,77329,1,DL
4,1999,63857,13485,77342,2,DL
5,1999,63967,13340,77307,2,DL
6,1999,63931,13715,77646,2,DL
7,1999,64151,13711,77862,3,DL
8,1999,64000,13618,77618,3,DL
9,1999,63674,13912,77586,3,DL
10,1999,63931,13651,77582,4,DL
11,1999,63568,14160,77728,4,DL
12,1999,64175,13788,77963,4,DL
1,2000,63532,14449,77981,1,DL
2,2000,64263,13886,78149,1,DL
3,2000,65862,13102,78964,1,DL
4,2000,65862,13102,78964,2,DL
5,2000,66033,13246,79279,2,DL
6,2000,66364,13193,79557,2,DL
7,2000,66349,15138,81487,3,DL
8,2000,66297,13482,79779,3,DL
9,2000,65946,13853,79799,3,DL
10,2000,66490,13633,80123,4,DL
11,2000,66605,13359,79964,4,DL
12,2000,66758,13632,80390,4,DL
1,2001,66603,14061,80664,1,DL
2,2001,66147,14430,80577,1,DL
3,2001,66891,13488,80379,1,DL
4,2001,68739,13695,82434,2,DL
5,2001,69051,13908,82959,2,DL
6,2001,76877,6153,83030,2,DL
7,2001,69288,14184,83472,3,DL
8,2001,69095,13800,82895,3,DL
9,2001,68253,13952,82205,3,DL
10,2001,67423,13084,80507,4,DL
11,2001,64161,11957,76118,4,DL
12,2001,62401,11702,74103,4,DL
1,2002,60170,11194,71364,1,DL
2,2002,60264,11228,71492,1,DL
3,2002,60409,11195,71604,1,DL
4,2002,60340,9210,69550,2,DL
5,2002,60967,9217,70184,2,DL
6,2002,61143,9166,70309,2,DL
7,2002,61670,9184,70854,3,DL
8,2002,61560,9175,70735,3,DL
9,2002,61126,8969,70095,3,DL
10,2002,60942,9015,69957,4,DL
11,2002,60653,8846,69499,4,DL
12,2002,60002,8701,68703,4,DL
1,2003,58830,8371,67201,1,DL
2,2003,57875,8106,65981,1,DL
3,2003,57164,7855,65019,1,DL
4,2003,55545,6992,62537,2,DL
5,2003,55029,6862,61891,2,DL
6,2003,54897,6938,61835,2,DL
7,2003,55453,7147,62600,3,DL
8,2003,55469,7135,62604,3,DL
9,2003,55055,6822,61877,3,DL
10,2003,55220,6767,61987,4,DL
11,2003,55257,6611,61868,4,DL
12,2003,55281,6846,62127,4,DL
1,2004,55177,6431,61608,1,DL
2,2004,54920,6391,61311,1,DL
3,2004,54742,6195,60937,1,DL
4,2004,54901,6396,61297,2,DL
5,2004,55016,6435,61451,2,DL
6,2004,54616,6598,61214,2,DL
7,2004,54534,6631,61165,3,DL
8,2004,54534,6631,61165,3,DL
9,2004,53985,6516,60501,3,DL
10,2004,53890,6428,60318,4,DL
11,2004,53650,6400,60050,4,DL
12,2004,53394,6578,59972,4,DL
1,2005,52312,6478,58790,1,DL
2,2005,51269,6522,57791,1,DL
3,2005,50783,6614,57397,1,DL
4,2005,49690,6494,56184,2,DL
5,2005,50016,6412,56428,2,DL
6,2005,49488,6370,55858,2,DL
7,2005,49178,6322,55500,3,DL
8,2005,48826,6282,55108,3,DL
9,2005,47765,5960,53725,3,DL
10,2005,47412,5853,53265,4,DL
11,2005,46980,5569,52549,4,DL
12,2005,45933,5324,51257,4,DL
1,2006,45822,4162,49984,1,DL
2,2006,45307,4136,49443,1,DL
3,2006,45020,4108,49128,1,DL
4,2006,43895,4200,48095,2,DL
5,2006,43058,4297,47355,2,DL
6,2006,42929,4324,47253,2,DL
7,2006,43085,4362,47447,3,DL
8,2006,42851,4387,47238,3,DL
9,2006,42191,4438,46629,3,DL
10,2006,42241,4485,46726,4,DL
11,2006,41948,4462,46410,4,DL
12,2006,42443,4406,46849,4,DL
1,2007,42313,4419,46732,1,DL
2,2007,42816,4388,47204,1,DL
3,2007,43350,4509,47859,1,DL
4,2007,43636,4784,48420,2,DL
5,2007,44165,4819,48984,2,DL
6,2007,46446,4771,51217,2,DL
7,2007,46455,4823,51278,3,DL
8,2007,46073,4963,51036,3,DL
9,2007,45783,5021,50804,3,DL
10,2007,45917,4997,50914,4,DL
11,2007,46119,5105,51224,4,DL
12,2007,45860,5114,50974,4,DL
1,2008,45413,5240,50653,1,DL
2,2008,45898,5225,51123,1,DL
3,2008,46192,5320,51512,1,DL
4,2008,46315,5258,51573,2,DL
5,2008,46178,5305,51483,2,DL
6,2008,46371,5308,51679,2,DL
7,2008,45449,5226,50675,3,DL
8,2008,44579,5240,49819,3,DL
9,2008,43536,5466,49002,3,DL
10,2008,42942,5460,48402,4,DL
11,2008,42389,5558,47947,4,DL
12,2008,42607,5641,48248,4,DL
1,2009,42159,5650,47809,1,DL
2,2009,42449,5750,48199,1,DL
3,2009,42443,5990,48433,1,DL
4,2009,42386,5867,48253,2,DL
5,2009,42458,6049,48507,2,DL
6,2009,42492,6193,48685,2,DL
7,2009,42686,6520,49206,3,DL
8,2009,42694,6353,49047,3,DL
9,2009,42233,6199,48432,3,DL
10,2009,44704,8619,53323,4,DL
11,2009,44663,8659,53322,4,DL
12,2009,44633,8652,53285,4,DL
1,2010,69593,11139,80732,1,DL
2,2010,69186,10922,80108,1,DL
3,2010,69245,10965,80210,1,DL
4,2010,69263,10947,80210,2,DL
5,2010,69267,10805,80072,2,DL
6,2010,70125,10850,80975,2,DL
7,2010,69950,11025,80975,3,DL
8,2010,70180,11027,81207,3,DL
9,2010,70200,11187,81387,3,DL
10,2010,68372,9349,77721,4,DL
11,2010,68493,9358,77851,4,DL
12,2010,68500,9570,78070,4,DL
1,2011,69208,9571,78779,1,DL
2,2011,69681,9774,79455,1,DL
3,2011,70628,9555,80183,1,DL
4,2011,70462,9234,79696,2,DL
5,2011,70429,9806,80235,2,DL
6,2011,71379,10117,81496,2,DL
7,2011,71295,9984,81279,3,DL
8,2011,70952,9582,80534,3,DL
9,2011,69337,9417,78754,3,DL
10,2011,68690,9347,78037,4,DL
11,2011,68550,9638,78188,4,DL
12,2011,68415,9511,77926,4,DL
1,2012,68482,9384,77866,1,DL
2,2012,68725,9480,78205,1,DL
3,2012,68857,9736,78593,1,DL
4,2012,68861,10013,78874,2,DL
5,2012,69024,10674,79698,2,DL
6,2012,69313,10930,80243,2,DL
7,2012,69111,10885,79996,3,DL
8,2012,69098,10471,79569,3,DL
9,2012,67964,9507,77471,3,DL
10,2012,67865,9643,77508,4,DL
11,2012,67851,9721,77572,4,DL
12,2012,67669,9720,77389,4,DL
1,2013,68482,9384,77866,1,DL
2,2013,68725,9480,78205,1,DL
3,2013,68697,9396,78093,1,DL
4,2013,69021,9684,78705,2,DL
5,2013,69020,10529,79549,2,DL
6,2013,69348,10396,79744,2,DL
7,2013,69063,10297,79360,3,DL
8,2013,68911,9924,78835,3,DL
9,2013,68835,9219,78054,3,DL
10,2013,68768,9448,78216,4,DL
11,2013,68830,9490,78320,4,DL
12,2013,68587,9538,78125,4,DL
1,2014,68600,9544,78144,1,DL
2,2014,68817,9569,78386,1,DL
3,2014,69725,9592,79317,1,DL
4,2014,70027,9938,79965,2,DL
5,2014,70201,11037,81238,2,DL
6,2014,70567,10710,81277,2,DL
7,2014,70728,10746,81474,3,DL
8,2014,70611,10245,80856,3,DL
9,2014,70908,9416,80324,3,DL
10,2014,70893,9765,80658,4,DL
11,2014,70603,9767,80370,4,DL
12,2014,70755,9963,80718,4,DL
1,2015,71106,9809,80915,1,DL
2,2015,71315,10249,81564,1,DL
3,2015,71815,10379,82194,1,DL
4,2015,72437,10730,83167,2,DL
5,2015,73099,11242,84341,2,DL
6,2015,73532,11196,84728,2,DL
7,2015,73535,11163,84698,3,DL
8,2015,73812,10629,84441,3,DL
9,2015,74159,10232,84391,3,DL
10,2015,74122,10567,84689,4,DL
11,2015,73848,10536,84384,4,DL
12,2015,73693,10758,84451,4,DL
1,2016,73457,10511,83968,1,DL
2,2016,73803,10821,84624,1,DL
3,2016,74094,10948,85042,1,DL
4,2016,74507,10604,85111,2,DL
5,2016,74567,11232,85799,2,DL
6,2016,74601,11567,86168,2,DL
7,2016,74590,11398,85988,3,DL
8,2016,74632,11126,85758,3,DL
9,2016,74867,10257,85124,3,DL
10,2016,75079,10330,85409,4,DL
11,2016,73989,10715,84704,4,DL
12,2016,74198,10498,84696,4,DL
1,2017,74052,10210,84262,1,DL
2,2017,74327,10365,84692,1,DL
3,2017,75419,10588,86007,1,DL
4,2017,75658,10848,86506,2,DL
5,2017,75946,10951,86897,2,DL
6,2017,76799,11259,88058,2,DL
7,2017,76334,11229,87563,3,DL
8,2017,76475,10848,87323,3,DL
9,2017,76599,10195,86794,3,DL
10,2017,76960,10421,87381,4,DL
11,2017,76175,10662,86837,4,DL
12,2017,76285,10959,87244,4,DL
1,2018,76010,10953,86963,1,DL
2,2018,76150,11244,87394,1,DL
3,2018,77365,10799,88164,1,DL
4,2018,77600,10519,88119,2,DL
5,2018,78261,10430,88691,2,DL
6,2018,78339,10907,89246,2,DL
7,2018,80775,12673,93448,3,DL
8,2018,77903,10740,88643,3,DL
9,2018,78037,10240,88277,3,DL
10,2018,77951,10283,88234,4,DL
11,2018,77101,10640,87741,4,DL
12,2018,77285,10811,88096,4,DL
1,2019,78055,10684,88739,1,DL
2,2019,78645,10846,89491,1,DL
3,2019,79067,10892,89959,1,DL
4,2019,79307,10660,89967,2,DL
5,2019,79502,10929,90431,2,DL
6,2019,79601,11688,91289,2,DL
7,2019,79462,11651,91113,3,DL
8,2019,79502,11192,90694,3,DL
9,2019,79512,10417,89929,3,DL
10,2019,79931,10371,90302,4,DL
11,2019,79636,10360,89996,4,DL
12,2019,79841,10565,90406,4,DL
1,2020,80582,10245,90827,1,DL
2,2020,81177,10239,91416,1,DL
3,2020,80179,9801,89980,1,DL
4,2020,57498,4512,62010,2,DL
5,2020,47581,3403,50984,2,DL
6,2020,47877,3591,51468,2,DL
7,2020,56513,5563,62076,3,DL
8,2020,57630,5716,63346,3,DL
9,2020,55767,5743,61510,3,DL
10,2020,55384,5845,61229,4,DL
11,2020,56393,5885,62278,4,DL
12,2020,56827,5959,62786,4,DL
1,2021,56429,5758,62187,1,DL
2,2021,56933,5655,62588,1,DL
3,2021,58406,5821,64227,1,DL
4,2021,59348,6311,65659,2,DL
5,2021,61045,7288,68333,2,DL
6,2021,62248,9029,71277,2,DL
7,2021,68699,4805,73504,3,DL
8,2021,71804,3280,75084,3,DL
9,2021,74393,2787,77180,3,DL
10,2021,77410,2156,79566,4,DL
11,2021,78447,2380,80827,4,DL
12,2021,79299,2380,81679,4,DL
1,2022,80655,1965,82620,1,DL
2,2022,82439,1885,84324,1,DL
3,2022,83951,1823,85774,1,DL
4,2022,85359,1795,87154,2,DL
5,2022,86831,2364,89195,2,DL
6,2022,88649,3531,92180,2,DL
7,2022,89331,3568,92899,3,DL
8,2022,90039,2578,92617,3,DL
9,2022,91834,2094,93928,3,DL
10,2022,92459,1957,94416,4,DL
11,2022,93007,2449,95456,4,DL
12,2022,92734,2661,95395,4,DL
1,2023,94236,2508,96744,1,DL
2,2023,95551,2400,97951,1,DL
3,2023,96510,2219,98729,1,DL
4,2023,97513,1475,98988,2,DL
5,2023,98455,1884,100339,2,DL
6,2023,99404,2929,102333,2,DL
7,2023,99944,2990,102934,3,DL
8,2023,100435,2106,102541,3,DL
9,2023,101162,1699,102861,3,DL
10,2023,101724,1927,103651,4,DL
11,2023,101182,2922,104104,4,DL
12,2023,101436,2969,104405,4,DL
1,2024,100932,2268,103200,1,DL
2,2024,101834,2165,103999,1,DL
3,2024,102655,2189,104844,1,DL
4,2024,102384,1513,103897,2,DL
5,2024,103035,2046,105081,2,DL
6,2024,103018,3280,106298,2,DL
7,2024,102936,3296,106232,3,DL
8,2024,102943,2247,105190,3,DL
9,2024,103249,1443,104692,3,DL
10,2024,103279,1562,104841,4,DL
11,2024,102032,2106,104138,4,DL
12,2024,102223,2693,104916,4,DL
1,1990,68137,9039,77176,1,AA
2,1990,68725,9273,77998,1,AA
3,1990,69509,9376,78885,1,AA
4,1990,69713,9326,79039,2,AA
5,1990,70376,9309,79685,2,AA
6,1990,71258,9369,80627,2,AA
7,1990,72018,9651,81669,3,AA
8,1990,72513,9694,82207,3,AA
9,1990,72776,9788,82564,3,AA
10,1990,73111,9737,82848,4,AA
11,1990,73171,9492,82663,4,AA
12,1990,73726,9507,83233,4,AA
1,1991,73867,9426,83293,1,AA
2,1991,73490,9934,83424,1,AA
3,1991,73538,10192,83730,1,AA
4,1991,74075,10246,84321,2,AA
5,1991,74853,10427,85280,2,AA
6,1991,75683,10716,86399,2,AA
7,1991,76563,10876,87439,3,AA
8,1991,76887,11029,87916,3,AA
9,1991,82579,12560,95139,3,AA
10,1991,82722,12785,95507,4,AA
11,1991,83237,12293,95530,4,AA
12,1991,83561,12531,96092,4,AA
1,1992,83649,12361,96010,1,AA
2,1992,83428,12741,96169,1,AA
3,1992,83444,12644,96088,1,AA
4,1992,83514,12880,96394,2,AA
5,1992,83615,12747,96362,2,AA
6,1992,84149,12953,97102,2,AA
7,1992,84434,13174,97608,3,AA
8,1992,85148,13404,98552,3,AA
9,1992,85387,13333,98720,3,AA
10,1992,85203,13416,98619,4,AA
11,1992,85063,13025,98088,4,AA
12,1992,84716,13283,97999,4,AA
1,1993,84622,13396,98018,1,AA
2,1993,84654,13857,98511,1,AA
3,1993,84827,13815,98642,1,AA
4,1993,84687,13860,98547,2,AA
5,1993,84274,14185,98459,2,AA
6,1993,83730,14395,98125,2,AA
7,1993,83483,14463,97946,3,AA
8,1993,83306,14498,97804,3,AA
9,1993,82940,14170,97110,3,AA
10,1993,82694,13951,96645,4,AA
11,1993,84590,12831,97421,4,AA
12,1993,83047,12901,95948,4,AA
1,1994,81485,14034,95519,1,AA
2,1994,80886,14117,95003,1,AA
3,1994,80572,14065,94637,1,AA
4,1994,80584,13950,94534,2,AA
5,1994,79337,14725,94062,2,AA
6,1994,79144,14846,93990,2,AA
7,1994,78765,14915,93680,3,AA
8,1994,78786,14976,93762,3,AA
9,1994,78923,14224,93147,3,AA
10,1994,78678,14170,92848,4,AA
11,1994,78060,14472,92532,4,AA
12,1994,77822,14617,92439,4,AA
1,1995,78112,13883,91995,1,AA
2,1995,78095,13431,91526,1,AA
3,1995,78112,13313,91425,1,AA
4,1995,77802,13177,90979,2,AA
5,1995,78053,12799,90852,2,AA
6,1995,78276,12704,90980,2,AA
7,1995,78292,12779,91071,3,AA
8,1995,78335,12783,91118,3,AA
9,1995,78764,12519,91283,3,AA
10,1995,78680,12564,91244,4,AA
11,1995,79104,12806,91910,4,AA
12,1995,79349,13260,92609,4,AA
1,1996,79586,13466,93052,1,AA
2,1996,79807,13210,93017,1,AA
3,1996,79425,13231,92656,1,AA
4,1996,79172,13144,92316,2,AA
5,1996,78456,13576,92032,2,AA
6,1996,78446,13722,92168,2,AA
7,1996,71789,13722,85511,3,AA
8,1996,73716,12268,85984,3,AA
9,1996,72053,13607,85660,3,AA
10,1996,72122,13580,85702,4,AA
11,1996,72287,13553,85840,4,AA
12,1996,74303,12296,86599,4,AA
1,1997,72590,13635,86225,1,AA
2,1997,72365,13735,86100,1,AA
3,1997,72069,14177,86246,1,AA
4,1997,72053,14219,86272,2,AA
5,1997,73134,13374,86508,2,AA
6,1997,73736,13512,87248,2,AA
7,1997,73988,13882,87870,3,AA
8,1997,74977,13358,88335,3,AA
9,1997,73993,13800,87793,3,AA
10,1997,73889,13783,87672,4,AA
11,1997,73893,13817,87710,4,AA
12,1997,74735,13568,88303,4,AA
1,1998,73967,13732,87699,1,AA
2,1998,73534,13868,87402,1,AA
3,1998,73680,13889,87569,1,AA
4,1998,73721,13846,87567,2,AA
5,1998,73386,14233,87619,2,AA
6,1998,73754,14322,88076,2,AA
7,1998,74047,14443,88490,3,AA
8,1998,75472,13850,89322,3,AA
9,1998,74643,14435,89078,3,AA
10,1998,75109,14446,89555,4,AA
11,1998,75426,14497,89923,4,AA
12,1998,76343,14117,90460,4,AA
1,1999,75251,14720,89971,1,AA
2,1999,76231,14707,90938,1,AA
3,1999,76682,14590,91272,1,AA
4,1999,77024,14881,91905,2,AA
5,1999,77645,15042,92687,2,AA
6,1999,78217,15118,93335,2,AA
7,1999,78872,15447,94319,3,AA
8,1999,80007,14901,94908,3,AA
9,1999,80737,15502,96239,3,AA
10,1999,80987,15360,96347,4,AA
11,1999,81162,15281,96443,4,AA
12,1999,82264,14935,97199,4,AA
1,2000,81420,15474,96894,1,AA
2,2000,81769,15585,97354,1,AA
3,2000,82755,15541,98296,1,AA
4,2000,82701,15439,98140,2,AA
5,2000,83064,15459,98523,2,AA
6,2000,83605,15562,99167,2,AA
7,2000,83767,15529,99296,3,AA
8,2000,85140,14676,99816,3,AA
9,2000,84636,15143,99779,3,AA
10,2000,85069,15035,100104,4,AA
11,2000,85675,14995,100670,4,AA
12,2000,86683,14536,101219,4,AA
1,2001,86075,15133,101208,1,AA
2,2001,86275,15083,101358,1,AA
3,2001,87025,15183,102208,1,AA
4,2001,87286,15140,102426,2,AA
5,2001,87156,15162,102318,2,AA
6,2001,87286,15140,102426,2,AA
7,2001,88665,15177,103842,3,AA
8,2001,88665,14177,102842,3,AA
9,2001,84660,13279,97939,3,AA
10,2001,84016,12838,96854,4,AA
11,2001,78113,13298,91411,4,AA
12,2001,77692,13384,91076,4,AA
1,2002,90518,14972,105490,1,AA
2,2002,89655,14577,104232,1,AA
3,2002,88806,14575,103381,1,AA
4,2002,88586,14421,103007,2,AA
5,2002,91364,15014,106378,2,AA
6,2002,91332,15247,106579,2,AA
7,2002,90721,15817,106538,3,AA
8,2002,91839,15472,107311,3,AA
9,2002,91774,15295,107069,3,AA
10,2002,91521,15447,106968,4,AA
11,2002,88988,14826,103814,4,AA
12,2002,88256,13857,102113,4,AA
1,2003,87837,13777,101614,1,AA
2,2003,88256,13857,102113,1,AA
3,2003,83708,13686,97394,1,AA
4,2003,82511,13571,96082,2,AA
5,2003,81207,13372,94579,2,AA
6,2003,78935,13146,92081,2,AA
7,2003,76097,12299,88396,3,AA
8,2003,75801,12236,88037,3,AA
9,2003,74646,12037,86683,3,AA
10,2003,73599,11569,85168,4,AA
11,2003,73858,11611,85469,4,AA
12,2003,73858,11611,85469,4,AA
1,2004,73581,11254,84835,1,AA
2,2004,73618,11136,84754,1,AA
3,2004,73455,11186,84641,1,AA
4,2004,73520,11187,84707,2,AA
5,2004,73596,11149,84745,2,AA
6,2004,73480,11169,84649,2,AA
7,2004,74259,11145,85404,3,AA
8,2004,74245,11137,85382,3,AA
9,2004,73636,11060,84696,3,AA
10,2004,73209,10905,84114,4,AA
11,2004,73287,10986,84273,4,AA
12,2004,72260,11028,83288,4,AA
1,2005,71232,10990,82222,1,AA
2,2005,70592,10910,81502,1,AA
3,2005,70184,11007,81191,1,AA
4,2005,69892,11063,80955,2,AA
5,2005,70495,11136,81631,2,AA
6,2005,70306,11282,81588,2,AA
7,2005,74087,12814,86901,3,AA
8,2005,70200,11409,81609,3,AA
9,2005,69864,11192,81056,3,AA
10,2005,69571,11063,80634,4,AA
11,2005,69466,11111,80577,4,AA
12,2005,69130,11388,80518,4,AA
1,2006,69028,11337,80365,1,AA
2,2006,68982,11268,80250,1,AA
3,2006,68825,11204,80029,1,AA
4,2006,68792,10998,79790,2,AA
5,2006,68205,11252,79457,2,AA
6,2006,68069,10712,78781,2,AA
7,2006,67954,10691,78645,3,AA
8,2006,68037,10585,78622,3,AA
9,2006,67640,10543,78183,3,AA
10,2006,67438,10566,78004,4,AA
11,2006,67861,10566,78427,4,AA
12,2006,67768,10402,78170,4,AA
1,2007,67521,10345,77866,1,AA
2,2007,67384,10264,77648,1,AA
3,2007,67809,10739,78548,1,AA
4,2007,67813,10721,78534,2,AA
5,2007,67870,10710,78580,2,AA
6,2007,67606,10672,78278,2,AA
7,2007,67583,10643,78226,3,AA
8,2007,67812,10616,78428,3,AA
9,2007,67939,10514,78453,3,AA
10,2007,68004,10510,78514,4,AA
11,2007,67849,10873,78722,4,AA
12,2007,67747,10954,78701,4,AA
1,2008,67834,10898,78732,1,AA
2,2008,67738,10827,78565,1,AA
3,2008,67694,10799,78493,1,AA
4,2008,67679,10764,78443,2,AA
5,2008,67902,10732,78634,2,AA
6,2008,67787,10669,78456,2,AA
7,2008,67771,10667,78438,3,AA
8,2008,67187,10628,77815,3,AA
9,2008,65522,10179,75701,3,AA
10,2008,65326,10132,75458,4,AA
11,2008,65143,9990,75133,4,AA
12,2008,65134,9940,75074,4,AA
1,2009,64987,9917,74904,1,AA
2,2009,64979,9912,74891,1,AA
3,2009,64977,9913,74890,1,AA
4,2009,64975,9911,74886,2,AA
5,2009,63500,9832,73332,2,AA
6,2009,63404,9742,73146,2,AA
7,2009,63258,9664,72922,3,AA
8,2009,62959,9692,72651,3,AA
9,2009,62917,9604,72521,3,AA
10,2009,62027,9750,71777,4,AA
11,2009,61680,9666,71346,4,AA
12,2009,61855,9595,71450,4,AA
1,2010,61983,9300,71283,1,AA
2,2010,61906,9263,71169,1,AA
3,2010,61485,9363,70848,1,AA
4,2010,61209,9351,70560,2,AA
5,2010,61094,9342,70436,2,AA
6,2010,61291,9204,70495,2,AA
7,2010,61184,9161,70345,3,AA
8,2010,61133,9164,70297,3,AA
9,2010,60829,9083,69912,3,AA
10,2010,60766,9033,69799,4,AA
11,2010,60843,9036,69879,4,AA
12,2010,61229,8987,70216,4,AA
1,2011,61197,8966,70163,1,AA
2,2011,61571,8925,70496,1,AA
3,2011,61709,8983,70692,1,AA
4,2011,61911,8992,70903,2,AA
5,2011,61832,9038,70870,2,AA
6,2011,61977,9004,70981,2,AA
7,2011,62053,9016,71069,3,AA
8,2011,61831,8942,70773,3,AA
9,2011,61838,8909,70747,3,AA
10,2011,62019,8914,70933,4,AA
11,2011,61921,8872,70793,4,AA
12,2011,61684,8893,70577,4,AA
1,2012,61435,8865,70300,1,AA
2,2012,61016,8794,69810,1,AA
3,2012,61544,7851,69395,1,AA
4,2012,61383,7813,69196,2,AA
5,2012,61111,7738,68849,2,AA
6,2012,60743,7676,68419,2,AA
7,2012,60029,8390,68419,3,AA
8,2012,59655,8193,67848,3,AA
9,2012,59352,8089,67441,3,AA
10,2012,58761,7878,66639,4,AA
11,2012,57783,7347,65130,4,AA
12,2012,56024,7099,63123,4,AA
1,2013,55890,7072,62962,1,AA
2,2013,55959,7004,62963,1,AA
3,2013,55519,6973,62492,1,AA
4,2013,55597,6899,62496,2,AA
5,2013,55420,6915,62335,2,AA
6,2013,55735,6856,62591,2,AA
7,2013,55637,6837,62474,3,AA
8,2013,55726,6827,62553,3,AA
9,2013,55462,6828,62290,3,AA
10,2013,55838,6821,62659,4,AA
11,2013,56038,6847,62885,4,AA
12,2013,56017,6882,62899,4,AA
1,2014,56245,6881,63126,1,AA
2,2014,56242,6914,63156,1,AA
3,2014,56372,6926,63298,1,AA
4,2014,56435,6927,63362,2,AA
5,2014,56288,6918,63206,2,AA
6,2014,56391,6900,63291,2,AA
7,2014,56480,6964,63444,3,AA
8,2014,56174,6856,63030,3,AA
9,2014,56419,6819,63238,3,AA
10,2014,57043,6835,63878,4,AA
11,2014,57208,6812,64020,4,AA
12,2014,57308,6811,64119,4,AA
1,2015,57549,6900,64449,1,AA
2,2015,57891,7038,64929,1,AA
3,2015,58443,7294,65737,1,AA
4,2015,59068,7370,66438,2,AA
5,2015,59529,7390,66919,2,AA
6,2015,59905,7427,67332,2,AA
7,2015,90786,12080,102866,3,AA
8,2015,90620,12198,102818,3,AA
9,2015,90592,12215,102807,3,AA
10,2015,90810,12126,102936,4,AA
11,2015,91294,12133,103427,4,AA
12,2015,91242,12085,103327,4,AA
1,2016,91482,12054,103536,1,AA
2,2016,91407,11995,103402,1,AA
3,2016,91694,12058,103752,1,AA
4,2016,91917,12085,104002,2,AA
5,2016,92372,12112,104484,2,AA
6,2016,92653,12022,104675,2,AA
7,2016,92797,12022,104819,3,AA
8,2016,92938,11962,104900,3,AA
9,2016,93022,12030,105052,3,AA
10,2016,93065,12251,105316,4,AA
11,2016,93349,12154,105503,4,AA
12,2016,93435,12145,105580,4,AA
1,2017,93400,12179,105579,1,AA
2,2017,93721,12248,105969,1,AA
3,2017,94139,12312,106451,1,AA
4,2017,93896,12433,106329,2,AA
5,2017,94281,12494,106775,2,AA
6,2017,94110,12922,107032,2,AA
7,2017,94325,12982,107307,3,AA
8,2017,94123,13148,107271,3,AA
9,2017,94096,13165,107261,3,AA
10,2017,94144,13136,107280,4,AA
11,2017,94110,13115,107225,4,AA
12,2017,94080,13130,107210,4,AA
1,2018,94256,13151,107407,1,AA
2,2018,94303,13197,107500,1,AA
3,2018,94756,13303,108059,1,AA
4,2018,95457,12770,108227,2,AA
5,2018,96153,12750,108903,2,AA
6,2018,96543,12628,109171,2,AA
7,2018,96407,12538,108945,3,AA
8,2018,96005,12511,108516,3,AA
9,2018,95964,12450,108414,3,AA
10,2018,95915,12412,108327,4,AA
11,2018,95215,12358,107573,4,AA
12,2018,95249,12341,107590,4,AA
1,2019,94446,12353,106799,1,AA
2,2019,94466,12235,106701,1,AA
3,2019,94993,12279,107272,1,AA
4,2019,95373,12158,107531,2,AA
5,2019,95595,12178,107773,2,AA
6,2019,96045,12062,108107,2,AA
7,2019,95806,12012,107818,3,AA
8,2019,95061,11915,106976,3,AA
9,2019,95069,11912,106981,3,AA
10,2019,95541,11889,107430,4,AA
11,2019,95225,11899,107124,4,AA
12,2019,95518,11863,107381,4,AA
1,2020,95612,11840,107452,1,AA
2,2020,96021,11884,107905,1,AA
3,2020,97373,11735,109108,1,AA
4,2020,97083,11496,108579,2,AA
5,2020,96062,11284,107346,2,AA
6,2020,96061,11191,107252,2,AA
7,2020,95792,11236,107028,3,AA
8,2020,95312,11232,106544,3,AA
9,2020,95197,10973,106170,3,AA
10,2020,79281,11565,90846,4,AA
11,2020,78761,11613,90374,4,AA
12,2020,88418,12587,101005,4,AA
1,2021,87926,12483,100409,1,AA
2,2021,90255,11187,101442,1,AA
3,2021,90243,11060,101303,1,AA
4,2021,88211,10682,98893,2,AA
5,2021,86714,10951,97665,2,AA
6,2021,87718,11022,98740,2,AA
7,2021,88130,11023,99153,3,AA
8,2021,88345,10943,99288,3,AA
9,2021,86522,10968,97490,3,AA
10,2021,85979,11130,97109,4,AA
11,2021,86112,11414,97526,4,AA
12,2021,86324,11557,97881,4,AA
1,2022,87377,11823,99200,1,AA
2,2022,87999,12066,100065,1,AA
3,2022,89059,12453,101512,1,AA
4,2022,89379,12766,102145,2,AA
5,2022,90332,12814,103146,2,AA
6,2022,90598,12958,103556,2,AA
7,2022,90647,12944,103591,3,AA
8,2022,90399,12985,103384,3,AA
9,2022,90867,12861,103728,3,AA
10,2022,91114,12694,103808,4,AA
11,2022,91439,12625,104064,4,AA
12,2022,91293,12550,103843,4,AA
1,2023,92038,12507,104545,1,AA
2,2023,92443,12424,104867,1,AA
3,2023,93199,12553,105752,1,AA
4,2023,94248,12606,106854,2,AA
5,2023,95103,12709,107812,2,AA
6,2023,95655,12658,108313,2,AA
7,2023,95458,12509,107967,3,AA
8,2023,95286,12526,107812,3,AA
9,2023,95362,12601,107963,3,AA
10,2023,95722,12648,108370,4,AA
11,2023,95892,12535,108427,4,AA
12,2023,95285,12416,107701,4,AA
1,2024,95588,12370,107958,1,AA
2,2024,95654,12332,107986,1,AA
3,2024,95827,12306,108133,1,AA
4,2024,95864,12387,108251,2,AA
5,2024,96324,12373,108697,2,AA
6,2024,96543,12347,108890,2,AA
7,2024,96220,12266,108486,3,AA
8,2024,95149,12131,107280,3,AA
9,2024,95044,12247,107291,3,AA
10,2024,95921,12376,108297,4,AA
11,2024,95686,12357,108043,4,AA
12,2024,95328,12241,107569,4,AA
7,1998,24,0,24,3,G4
8,1998,24,0,24,3,G4
9,1998,25,0,25,3,G4
10,1998,26,0,26,4,G4
11,1998,25,0,25,4,G4
12,1998,24,0,24,4,G4
1,1999,25,0,25,1,G4
2,1999,26,0,26,1,G4
3,1999,29,0,29,1,G4
4,1999,29,0,29,2,G4
5,1999,38,7,45,2,G4
6,1999,47,19,66,2,G4
7,1999,47,19,66,3,G4
8,1999,49,19,68,3,G4
9,1999,50,29,79,3,G4
10,1999,52,31,83,4,G4
11,1999,64,25,89,4,G4
12,1999,65,32,97,4,G4
1,2000,63,32,95,1,G4
2,2000,63,36,99,1,G4
3,2000,72,27,99,1,G4
4,2000,92,11,103,2,G4
5,2000,76,30,106,2,G4
6,2000,81,32,113,2,G4
7,2000,100,48,148,3,G4
8,2000,103,49,152,3,G4
9,2000,100,54,154,3,G4
10,2000,107,52,159,4,G4
11,2000,107,52,159,4,G4
12,2000,42,6,48,4,G4
1,2001,39,7,46,1,G4
2,2001,41,8,49,1,G4
3,2001,39,8,47,1,G4
4,2001,39,8,47,2,G4
5,2001,39,8,47,2,G4
6,2001,43,6,49,2,G4
7,2001,45,10,55,3,G4
8,2001,49,9,58,3,G4
9,2001,47,9,56,3,G4
10,2001,49,7,56,4,G4
11,2001,49,7,56,4,G4
12,2001,47,9,56,4,G4
1,2002,66,13,79,1,G4
2,2002,68,12,80,1,G4
3,2002,73,13,86,1,G4
4,2002,77,16,93,2,G4
5,2002,80,16,96,2,G4
6,2002,75,17,92,2,G4
7,2002,81,21,102,3,G4
8,2002,102,21,123,3,G4
9,2002,89,24,113,3,G4
10,2002,102,24,126,4,G4
11,2002,103,19,122,4,G4
12,2002,96,21,117,4,G4
1,2003,102,23,125,1,G4
2,2003,102,24,126,1,G4
3,2003,97,23,120,1,G4
4,2003,129,24,153,2,G4
5,2003,135,25,160,2,G4
6,2003,160,30,190,2,G4
7,2003,152,75,227,3,G4
8,2003,180,79,259,3,G4
9,2003,180,79,259,3,G4
10,2003,243,45,288,4,G4
11,2003,234,38,272,4,G4
12,2003,254,55,309,4,G4
1,2004,263,51,314,1,G4
2,2004,265,59,324,1,G4
3,2004,295,61,356,1,G4
4,2004,286,57,343,2,G4
5,2004,303,55,358,2,G4
6,2004,302,65,367,2,G4
7,2004,323,84,407,3,G4
8,2004,311,79,390,3,G4
9,2004,324,82,406,3,G4
10,2004,317,84,401,4,G4
11,2004,326,88,414,4,G4
12,2004,339,93,432,4,G4
1,2005,341,92,433,1,G4
2,2005,348,92,440,1,G4
3,2005,384,100,484,1,G4
4,2005,371,111,482,2,G4
5,2005,393,117,510,2,G4
6,2005,399,113,512,2,G4
7,2005,406,101,507,3,G4
8,2005,407,102,509,3,G4
9,2005,436,74,510,3,G4
10,2005,470,73,543,4,G4
11,2005,486,136,622,4,G4
12,2005,517,76,593,4,G4
1,2006,531,171,702,1,G4
2,2006,553,195,748,1,G4
3,2006,574,205,779,1,G4
4,2006,579,224,803,2,G4
5,2006,612,227,839,2,G4
6,2006,616,246,862,2,G4
7,2006,625,248,873,3,G4
8,2006,646,278,924,3,G4
9,2006,646,281,927,3,G4
10,2006,685,285,970,4,G4
11,2006,710,281,991,4,G4
12,2006,701,289,990,4,G4
1,2007,727,281,1008,1,G4
2,2007,751,288,1039,1,G4
3,2007,766,297,1063,1,G4
4,2007,780,302,1082,2,G4
5,2007,796,321,1117,2,G4
6,2007,791,320,1111,2,G4
7,2007,793,346,1139,3,G4
8,2007,828,339,1167,3,G4
9,2007,855,360,1215,3,G4
10,2007,895,367,1262,4,G4
11,2007,954,372,1326,4,G4
12,2007,985,390,1375,4,G4
1,2008,986,377,1363,1,G4
2,2008,1028,383,1411,1,G4
3,2008,1082,395,1477,1,G4
4,2008,1110,395,1505,2,G4
5,2008,1107,385,1492,2,G4
6,2008,1110,378,1488,2,G4
7,2008,1116,407,1523,3,G4
8,2008,1108,397,1505,3,G4
9,2008,1086,392,1478,3,G4
10,2008,1113,387,1500,4,G4
11,2008,1122,427,1549,4,G4
12,2008,1135,425,1560,4,G4
1,2009,1138,429,1567,1,G4
2,2009,1177,442,1619,1,G4
3,2009,1199,439,1638,1,G4
4,2009,1235,437,1672,2,G4
5,2009,1239,443,1682,2,G4
6,2009,1262,446,1708,2,G4
7,2009,1269,447,1716,3,G4
8,2009,1272,452,1724,3,G4
9,2009,1289,460,1749,3,G4
10,2009,1284,461,1745,4,G4
11,2009,1315,454,1769,4,G4
12,2009,1339,452,1791,4,G4
1,2010,1328,406,1734,1,G4
2,2010,1362,396,1758,1,G4
3,2010,1401,392,1793,1,G4
4,2010,1429,388,1817,2,G4
5,2010,1442,374,1816,2,G4
6,2010,1443,380,1823,2,G4
7,2010,1443,374,1817,3,G4
8,2010,1436,376,1812,3,G4
9,2010,1433,370,1803,3,G4
10,2010,1445,363,1808,4,G4
11,2010,1430,368,1798,4,G4
12,2010,1428,361,1789,4,G4
1,2011,1427,399,1826,1,G4
2,2011,1449,340,1789,1,G4
3,2011,1443,331,1774,1,G4
4,2011,1455,316,1771,2,G4
5,2011,1418,225,1643,2,G4
6,2011,1438,256,1694,2,G4
7,2011,1425,229,1654,3,G4
8,2011,1432,230,1662,3,G4
9,2011,1428,234,1662,3,G4
10,2011,1445,235,1680,4,G4
11,2011,1450,224,1674,4,G4
12,2011,1479,222,1701,4,G4
1,2012,1494,225,1719,1,G4
2,2012,1535,225,1760,1,G4
3,2012,1584,222,1806,1,G4
4,2012,1615,226,1841,2,G4
5,2012,1625,215,1840,2,G4
6,2012,1638,211,1849,2,G4
7,2012,1644,204,1848,3,G4
8,2012,1644,203,1847,3,G4
9,2012,1662,213,1875,3,G4
10,2012,1657,244,1901,4,G4
11,2012,1655,247,1902,4,G4
12,2012,1693,245,1938,4,G4
1,2013,1685,246,1931,1,G4
2,2013,1733,267,2000,1,G4
3,2013,1731,296,2027,1,G4
4,2013,1751,295,2046,2,G4
5,2013,1750,312,2062,2,G4
6,2013,1758,311,2069,2,G4
7,2013,1875,300,2175,3,G4
8,2013,1787,320,2107,3,G4
9,2013,1831,333,2164,3,G4
10,2013,1847,323,2170,4,G4
11,2013,1880,335,2215,4,G4
12,2013,1894,341,2235,4,G4
1,2014,1907,346,2253,1,G4
2,2014,1960,347,2307,1,G4
3,2014,1963,333,2296,1,G4
4,2014,1924,329,2253,2,G4
5,2014,1990,316,2306,2,G4
6,2014,2060,347,2407,2,G4
7,2014,2059,336,2395,3,G4
8,2014,2084,328,2412,3,G4
9,2014,2150,122,2272,3,G4
10,2014,2172,326,2498,4,G4
11,2014,2235,326,2561,4,G4
12,2014,2245,319,2564,4,G4
1,2015,2237,320,2557,1,G4
2,2015,2304,311,2615,1,G4
3,2015,2292,302,2594,1,G4
4,2015,2292,300,2592,2,G4
5,2015,2371,298,2669,2,G4
6,2015,2394,318,2712,2,G4
7,2015,2406,309,2715,3,G4
8,2015,2466,307,2773,3,G4
9,2015,2494,312,2806,3,G4
10,2015,2570,333,2903,4,G4
11,2015,2570,333,2903,4,G4
12,2015,2674,337,3011,4,G4
1,2016,2729,330,3059,1,G4
2,2016,2828,359,3187,1,G4
3,2016,2844,360,3204,1,G4
4,2016,2919,353,3272,2,G4
5,2016,3024,367,3391,2,G4
6,2016,3041,364,3405,2,G4
7,2016,3241,364,3605,3,G4
8,2016,3063,356,3419,3,G4
9,2016,3095,376,3471,3,G4
10,2016,3154,386,3540,4,G4
11,2016,3041,364,3405,4,G4
12,2016,3235,354,3589,4,G4
1,2017,3253,351,3604,1,G4
2,2017,3311,354,3665,1,G4
3,2017,3344,374,3718,1,G4
4,2017,3556,370,3926,2,G4
5,2017,3424,374,3798,2,G4
6,2017,3432,383,3815,2,G4
7,2017,3467,379,3846,3,G4
8,2017,3485,421,3906,3,G4
9,2017,3492,415,3907,3,G4
10,2017,3538,411,3949,4,G4
11,2017,3560,400,3960,4,G4
12,2017,3545,406,3951,4,G4
1,2018,3541,415,3956,1,G4
2,2018,3576,414,3990,1,G4
3,2018,3566,420,3986,1,G4
4,2018,3589,407,3996,2,G4
5,2018,3622,430,4052,2,G4
6,2018,3619,441,4060,2,G4
7,2018,3629,439,4068,3,G4
8,2018,3643,436,4079,3,G4
9,2018,3622,426,4048,3,G4
10,2018,3643,425,4068,4,G4
11,2018,3646,435,4081,4,G4
12,2018,3643,516,4159,4,G4
1,2019,3526,435,3961,1,G4
2,2019,3636,430,4066,1,G4
3,2019,3615,442,4057,1,G4
4,2019,3644,458,4102,2,G4
5,2019,3676,448,4124,2,G4
6,2019,3729,462,4191,2,G4
7,2019,3711,470,4181,3,G4
8,2019,3748,445,4193,3,G4
9,2019,3824,455,4279,3,G4
10,2019,3896,456,4352,4,G4
11,2019,3926,461,4387,4,G4
12,2019,3908,457,4365,4,G4
1,2020,3935,459,4394,1,G4
2,2020,4001,477,4478,1,G4
3,2020,4070,417,4487,1,G4
4,2020,4084,413,4497,2,G4
5,2020,4069,406,4475,2,G4
6,2020,4036,400,4436,2,G4
7,2020,4006,409,4415,3,G4
8,2020,3987,412,4399,3,G4
9,2020,3976,414,4390,3,G4
10,2020,3730,422,4152,4,G4
11,2020,3756,418,4174,4,G4
12,2020,3748,409,4157,4,G4
1,2021,3746,409,4155,1,G4
2,2021,3756,420,4176,1,G4
3,2021,3748,424,4172,1,G4
4,2021,3774,421,4195,2,G4
5,2021,3833,468,4301,2,G4
6,2021,3872,477,4349,2,G4
7,2021,3923,494,4417,3,G4
8,2021,3976,513,4489,3,G4
9,2021,3973,539,4512,3,G4
10,2021,4052,537,4589,4,G4
11,2021,4105,560,4665,4,G4
12,2021,4157,550,4707,4,G4
1,2022,4235,563,4798,1,G4
2,2022,4332,580,4912,1,G4
3,2022,4403,578,4981,1,G4
4,2022,4520,566,5086,2,G4
5,2022,4656,701,5357,2,G4
6,2022,4810,740,5550,2,G4
7,2022,4811,725,5536,3,G4
8,2022,4838,703,5541,3,G4
9,2022,4931,708,5639,3,G4
10,2022,4961,694,5655,4,G4
11,2022,5004,662,5666,4,G4
12,2022,4982,648,5630,4,G4
1,2023,5000,670,5670,1,G4
2,2023,4994,672,5666,1,G4
3,2023,4974,672,5646,1,G4
4,2023,5007,696,5703,2,G4
5,2023,5088,731,5819,2,G4
6,2023,5060,751,5811,2,G4
7,2023,5099,735,5834,3,G4
8,2023,5116,727,5843,3,G4
9,2023,5177,802,5979,3,G4
10,2023,5199,835,6034,4,G4
11,2023,5230,845,6075,4,G4
12,2023,5226,834,6060,4,G4
1,2024,5363,897,6260,1,G4
2,2024,5438,973,6411,1,G4
3,2024,5453,996,6449,1,G4
4,2024,5444,993,6437,2,G4
5,2024,5499,994,6493,2,G4
6,2024,5493,1000,6493,2,G4
7,2024,5449,975,6424,3,G4
8,2024,5426,938,6364,3,G4
9,2024,5382,889,6271,3,G4
10,2024,5455,933,6388,4,G4
11,2024,5533,964,6497,4,G4
12,2024,5516,950,6466,4,G4
